740 740 218 98 220 258 259 259 259 259 259 259 259 259 259 259 259 259 259 259 259 259 259 259 259 259 259 259 260 218 220 218 98 220 740 740 740 740 740 740 
740 740 218 98 220 0 0 0 0 0 0 0 0 0 0 0 0 0 0 0 0 0 0 0 0 0 0 0 0 218 220 218 98 220 740 740 740 740 740 740 
740 740 218 98 220 0 0 0 0 0 0 0 0 0 0 0 0 0 0 0 0 0 0 0 0 0 0 0 0 218 220 218 98 220 740 740 740 740 740 740 
740 740 218 98 220 0 0 0 0 0 0 0 0 0 0 0 0 0 0 0 0 0 0 0 0 0 0 0 0 218 220 218 98 220 740 740 740 740 740 740 
740 740 218 98 220 0 0 0 0 0 0 0 0 0 0 0 0 0 0 0 0 0 0 0 0 0 0 0 0 218 220 218 98 220 740 740 740 740 740 740 
740 740 218 98 220 0 0 0 0 0 0 0 0 0 0 0 0 0 0 0 0 0 0 0 0 0 0 0 0 218 220 218 98 220 740 740 740 740 740 740 
179 179 140 98 220 0 0 0 0 0 0 0 0 0 0 0 0 0 0 0 0 0 0 0 0 0 0 0 0 218 220 218 98 139 179 179 179 179 179 179 
98 98 98 98 220 0 0 0 0 0 0 0 0 0 0 0 0 0 0 0 0 0 0 0 0 0 0 0 0 218 220 218 98 98 98 98 98 98 98 98 
259 259 259 259 260 0 0 0 0 0 6 6 0 0 0 0 0 0 0 0 0 0 0 6 6 0 0 0 0 218 220 258 259 259 259 259 259 259 259 259 
0 0 0 178 180 0 0 0 0 0 178 180 0 0 0 0 0 0 0 0 0 0 0 178 180 0 0 0 0 218 220 0 0 0 0 0 0 0 0 0 
0 0 0 218 220 0 0 0 0 0 218 220 0 0 0 0 0 0 0 0 0 0 0 218 220 0 0 0 0 218 220 0 0 0 0 0 0 0 0 0 
0 0 0 218 220 0 0 0 0 0 218 220 0 0 0 0 0 0 0 0 0 0 0 218 220 0 0 0 0 218 220 0 0 0 0 0 0 0 0 0 
0 0 0 218 220 0 0 0 0 0 218 220 0 0 0 0 0 0 0 0 0 0 0 218 220 0 0 0 0 218 220 0 0 0 0 0 0 0 0 0 
0 0 0 218 220 0 0 0 0 0 218 220 0 0 0 0 0 0 0 0 0 0 0 258 260 0 0 0 0 218 220 0 0 0 0 0 0 0 0 0 
0 0 0 218 220 0 0 0 0 0 218 220 0 0 0 0 0 0 0 0 0 0 0 7 7 0 0 0 0 218 220 0 0 0 0 0 0 0 0 0 
0 0 0 218 220 0 0 0 0 0 218 220 0 0 0 0 0 0 0 0 0 0 0 0 0 0 0 0 0 218 220 0 0 0 0 0 0 0 0 0 
0 0 0 258 260 0 0 0 0 0 218 220 0 0 0 0 0 0 0 0 0 0 0 0 0 0 0 0 0 218 220 0 0 0 0 0 0 0 0 0 
179 179 179 179 180 0 0 0 0 0 218 220 0 0 0 0 0 0 0 0 0 0 0 0 0 0 0 0 0 218 220 0 0 0 0 178 179 179 179 179 
98 98 98 98 220 0 0 0 0 0 218 220 0 0 0 0 6 6 0 0 0 0 0 0 0 0 0 0 0 218 220 0 0 0 0 218 98 98 98 98 
98 98 98 98 220 0 0 0 0 0 218 220 0 0 0 0 98 98 0 0 0 0 0 0 0 0 0 0 0 258 260 0 0 0 0 218 98 98 98 98 
98 98 98 98 220 0 0 0 0 0 218 220 0 0 0 0 7 7 0 0 0 0 0 0 0 0 0 0 0 7 7 0 0 0 0 218 98 98 98 98 
259 259 100 98 220 0 0 0 0 0 218 220 0 0 0 0 0 0 0 0 0 0 0 0 0 0 0 0 0 0 0 0 0 0 0 218 98 98 98 98 
740 740 218 98 220 0 0 0 0 0 218 220 0 0 0 0 0 0 0 0 0 0 0 0 0 0 0 0 0 0 0 0 0 0 0 218 98 98 98 98 
740 740 218 98 220 0 0 0 0 0 218 220 0 0 0 0 0 0 0 0 0 0 0 0 0 0 0 0 0 0 0 0 0 0 0 258 259 259 259 259 
740 740 218 98 220 0 0 0 0 0 218 220 0 0 0 0 0 0 0 0 0 0 0 178 179 179 179 179 179 179 179 179 179 179 179 179 179 179 179 179 
740 740 218 98 220 0 0 0 0 0 218 220 0 0 0 0 0 0 0 0 0 0 0 218 98 98 98 98 98 98 98 98 98 98 98 98 98 98 98 98 
740 740 218 98 220 0 0 0 0 0 218 220 0 0 0 0 0 0 0 0 0 0 0 218 98 99 259 259 259 259 259 259 259 259 259 259 259 259 259 259 
740 740 218 98 220 0 0 0 0 0 218 220 0 0 0 0 0 0 0 0 0 0 0 218 98 220 740 740 740 740 740 740 740 740 740 740 740 740 740 740 
740 740 218 98 220 0 0 0 0 0 218 220 178 179 179 179 179 179 179 179 179 179 180 218 98 220 740 740 740 740 740 740 740 740 740 740 740 740 740 740 
5
35 15 10 1
5 3 11 192
12 25 11 88
18 19 11 88
12 11 11 88
