740 740 740 740 740 740 740 740 740 740 740 740 740 740 740 740 740 218 98 220 0 0 0 0 0 0 0 0 0 0 0 0 0 0 0 0 0 0 0 0 
740 740 740 740 740 740 740 740 740 740 740 740 740 740 740 740 740 218 98 220 0 0 0 0 0 0 0 0 0 0 0 0 0 0 0 0 0 0 0 0 
179 179 179 179 179 179 179 179 179 179 179 179 179 179 179 179 179 140 98 220 0 0 0 0 0 0 0 0 0 0 0 0 0 0 0 0 0 0 0 0 
98 98 98 98 98 98 98 98 98 98 98 98 98 98 98 98 98 98 98 220 0 0 0 0 0 0 0 0 0 0 0 0 0 0 0 0 0 0 0 0 
259 259 259 259 259 259 259 259 259 259 259 259 259 259 259 259 259 259 259 260 0 0 0 0 0 0 0 0 0 0 0 0 0 0 0 0 0 0 0 0 
179 179 180 7 7 7 7 7 7 7 7 7 7 7 7 7 7 7 178 180 0 0 0 0 0 0 0 0 0 0 0 0 0 0 0 0 0 0 0 0 
98 98 220 0 0 0 0 0 0 0 0 0 0 0 0 0 0 0 218 220 0 0 0 0 0 0 0 0 0 0 0 0 0 0 0 0 0 0 0 0 
98 98 220 0 0 0 0 0 0 0 0 0 0 0 0 0 0 0 218 220 178 179 179 180 0 0 0 0 0 0 0 0 0 0 0 0 0 0 0 0 
259 259 260 0 0 0 0 0 0 0 0 0 0 0 0 0 0 0 258 260 258 259 259 260 0 0 0 0 0 0 0 0 0 0 0 0 0 0 0 0 
0 0 0 0 0 0 0 0 0 0 0 0 0 6 0 0 0 0 0 0 0 0 0 0 0 0 0 0 0 0 0 0 0 0 0 0 0 0 0 0 
0 0 0 0 0 0 0 0 0 0 0 0 50 740 49 0 0 0 0 0 0 0 0 0 0 0 0 0 0 0 0 0 0 0 0 0 0 0 0 0 
0 0 0 0 0 0 0 0 0 0 0 0 0 7 0 0 0 0 0 0 0 0 0 0 0 0 0 0 0 0 0 0 0 0 0 0 0 0 0 0 
0 0 0 0 0 0 0 0 0 0 0 0 0 0 0 0 0 0 0 0 0 0 0 0 0 0 0 0 0 0 0 0 0 0 0 0 0 0 0 0 
0 0 0 0 0 0 0 0 0 0 0 0 0 0 0 0 0 0 0 0 0 0 0 0 0 0 0 0 0 0 0 0 0 0 0 0 0 0 0 0 
0 0 0 0 0 0 0 6 0 0 0 0 0 0 0 0 0 0 0 0 0 0 0 0 0 0 0 0 0 0 0 0 0 0 0 0 0 0 0 0 
0 0 0 0 0 0 50 740 49 0 0 0 0 0 0 0 0 0 0 0 0 0 0 0 0 0 0 0 0 0 0 0 0 0 0 0 0 0 0 0 
0 0 0 0 0 0 0 7 0 0 0 0 0 0 0 0 0 0 0 0 0 0 0 0 0 0 0 0 0 0 0 0 0 0 0 0 0 0 0 0 
179 179 180 0 0 0 0 0 0 0 0 0 0 0 0 0 0 0 178 180 0 0 0 0 0 0 0 0 0 0 0 0 0 0 0 0 0 0 0 0 
98 98 220 0 0 0 0 0 0 0 0 0 0 0 0 0 0 0 218 220 0 0 0 0 0 0 0 0 0 0 0 0 0 0 0 0 0 0 0 0 
98 98 220 0 0 0 0 0 0 0 0 0 0 0 0 0 0 0 218 220 0 0 0 0 0 0 0 0 0 0 0 0 0 0 0 0 0 0 0 0 
259 259 260 6 6 6 6 6 6 6 6 6 6 6 6 6 6 6 258 260 0 0 0 0 0 0 0 0 0 0 0 0 0 0 0 0 0 0 0 0 
179 179 179 179 179 179 179 179 179 179 179 179 179 179 179 179 179 179 179 180 0 0 0 0 0 0 0 0 0 0 0 0 0 0 0 0 0 0 0 0 
98 98 98 98 98 98 98 98 98 98 98 98 98 98 98 98 98 98 98 220 0 0 0 0 0 0 0 0 0 0 0 0 0 0 0 0 0 0 0 0 
259 259 259 259 259 259 259 259 259 259 259 259 259 259 259 259 259 100 98 220 0 0 0 0 0 0 0 0 0 0 0 0 0 0 0 0 0 0 0 0 
740 740 740 740 740 740 740 740 740 740 740 740 740 740 740 740 740 218 98 220 0 0 0 0 0 0 0 0 0 0 0 0 0 0 0 0 0 0 0 0 
740 740 740 740 740 740 740 740 740 740 740 740 740 740 740 740 740 218 98 220 0 0 0 0 0 0 0 0 0 0 0 0 0 0 0 0 0 0 0 0 
740 740 740 740 740 740 740 740 740 740 740 740 740 740 740 740 740 218 98 220 0 0 0 0 0 0 0 0 0 0 0 0 0 0 0 0 0 0 0 0 
740 740 740 740 740 740 740 740 740 740 740 740 740 740 740 740 740 218 98 220 0 0 0 0 0 0 0 0 0 0 0 0 0 0 0 0 0 0 0 0 
740 740 740 740 740 740 740 740 740 740 740 740 740 740 740 740 740 218 98 220 0 0 0 0 0 0 0 0 0 0 0 0 0 0 0 0 0 0 0 0 
3
21 9 10 0
3 7 11 120
3 18 11 120
