740 218 98 220 218 98 98 98 98 98 98 98 98 220 0 0 0 0 0 0 218 98 220 740 740 740 740 740 740 740 740 740 740 740 740 740 740 740 740 740 
740 218 98 220 258 259 259 259 259 259 259 259 259 260 0 0 0 0 0 0 218 98 139 179 179 179 179 179 179 179 179 179 179 179 179 179 179 179 179 179 
740 218 98 220 0 0 0 0 0 0 0 0 0 0 0 0 0 0 0 0 218 98 98 98 98 98 98 98 98 98 98 98 98 98 98 98 98 98 98 98 
740 218 98 220 0 0 0 0 0 0 0 0 0 0 0 0 0 0 0 0 258 259 259 259 259 259 259 259 259 259 259 259 259 259 259 259 259 259 259 259 
740 218 98 220 0 0 0 0 0 0 0 0 0 0 0 0 0 0 0 0 178 179 179 180 7 7 7 7 7 7 7 7 7 7 7 7 7 178 179 179 
740 218 98 220 0 0 0 0 0 0 0 0 0 0 0 0 0 0 0 0 218 98 98 220 0 0 0 0 0 0 0 0 0 0 0 0 0 218 98 98 
740 218 98 220 0 0 0 0 0 0 0 0 0 0 0 0 0 0 0 0 218 98 98 220 0 0 0 0 0 0 0 0 0 0 0 0 0 218 98 98 
740 218 98 220 0 0 0 0 0 0 0 0 0 0 0 0 0 0 0 0 258 259 259 260 0 0 0 0 0 0 0 0 0 0 0 0 0 258 259 259 
740 218 98 220 0 0 0 0 178 179 179 179 179 179 179 179 179 179 179 179 179 179 179 180 0 0 0 0 0 0 0 0 0 0 0 0 0 7 7 7 
740 218 98 220 0 0 0 0 218 98 98 98 98 98 98 98 98 98 98 98 98 98 98 220 0 0 0 0 0 0 0 0 0 0 0 0 0 0 0 0 
740 218 98 220 0 0 0 0 258 259 259 259 259 259 259 259 259 259 259 259 259 259 259 260 0 0 0 0 0 0 0 0 0 0 0 0 0 0 0 0 
740 218 98 220 0 0 0 0 7 7 7 7 7 7 7 7 7 7 7 7 7 7 7 7 0 0 0 0 0 0 0 0 0 0 0 0 0 0 0 0 
740 218 98 220 0 0 0 0 0 0 0 0 0 0 0 0 0 0 0 0 0 0 0 0 0 0 0 0 0 0 0 0 0 0 0 0 0 0 0 0 
740 218 98 220 0 0 0 0 0 0 0 0 0 0 0 0 0 0 0 0 0 0 0 0 0 0 0 0 0 0 0 0 0 0 0 0 0 0 0 0 
740 218 98 220 0 0 0 0 0 0 0 0 0 0 0 0 0 0 0 0 0 0 0 0 0 0 0 0 0 0 0 0 0 0 0 0 0 0 0 0 
740 218 98 220 0 0 0 0 0 0 0 0 0 0 0 0 0 0 0 0 0 0 0 0 0 0 0 0 0 0 0 0 0 0 0 0 0 0 0 0 
740 218 98 220 0 0 0 0 0 0 0 0 0 0 0 0 0 0 0 0 0 0 0 0 0 0 0 0 178 179 179 179 179 179 179 179 179 179 179 179 
740 218 98 220 0 0 0 0 0 0 0 0 0 0 0 0 0 0 0 0 0 0 0 0 0 0 0 0 218 98 98 98 98 98 98 98 98 98 98 98 
740 218 98 220 0 0 0 0 0 0 0 0 0 0 0 0 0 0 0 0 0 0 0 0 0 0 0 0 218 98 99 259 259 259 259 259 259 259 259 259 
740 218 98 220 0 0 0 0 0 0 0 0 0 0 0 0 0 0 0 0 0 0 0 0 0 0 0 0 218 98 220 740 740 740 740 740 740 740 740 740 
740 218 98 220 0 0 0 0 0 0 0 0 0 0 0 0 0 0 0 0 0 0 0 0 0 0 0 0 218 98 220 740 740 740 740 740 740 740 740 740 
740 218 98 220 0 0 0 0 0 0 0 0 0 0 0 0 0 0 0 0 0 0 0 0 0 0 0 0 218 98 220 740 740 740 740 740 740 740 740 740 
740 218 98 220 0 0 0 0 0 0 0 0 0 6 6 0 0 0 0 0 0 0 0 0 0 0 0 0 218 98 220 740 740 740 740 740 740 740 740 740 
740 218 98 220 0 0 0 0 0 0 0 0 0 178 180 0 0 0 0 0 0 0 0 0 0 0 0 0 218 98 220 740 740 740 740 740 740 740 740 740 
740 218 98 220 0 0 0 0 0 0 0 0 0 218 220 0 0 0 0 0 0 0 0 0 0 0 0 0 218 98 220 740 740 740 740 740 740 740 740 740 
740 218 98 220 0 0 0 0 0 0 0 0 0 218 220 0 0 0 0 0 0 0 0 0 0 0 0 0 218 98 220 740 740 740 740 740 740 740 740 740 
740 218 98 220 6 6 6 6 6 6 6 6 6 218 220 6 6 6 6 6 6 6 6 6 6 6 6 6 218 98 220 740 740 740 740 740 740 740 740 740 
740 218 98 220 178 179 179 179 179 179 179 179 180 218 220 178 179 179 179 179 179 179 179 179 179 179 179 180 218 98 220 740 740 740 740 740 740 740 740 740 
740 218 98 220 218 98 98 98 98 98 98 98 220 218 220 218 98 98 98 98 98 98 98 98 98 98 98 220 218 98 220 740 740 740 740 740 740 740 740 740 
6
8 7 2 4 0 0 0 320 240
16 7 2 4 0 0 0 320 240
5 23 2 4 0 0 0 320 240
11 13 2 4 0 0 0 320 240
15 24 2 3 6 0 0 320 240
33 6 2 2 6 0 0 320 240
