98 220 0 0 0 218 98 98 98 98 98 98 98 98 98 98 98 98 98 98 98 98 98 98 98 98 98 98 98 98 98 98 98 98 98 98 98 98 98 98 
98 220 0 0 0 258 259 259 259 259 259 259 259 259 259 259 259 259 259 259 259 259 259 259 259 259 259 259 259 259 259 259 259 259 259 259 259 259 100 98 
98 220 0 0 0 740 740 7 7 7 7 7 7 7 740 740 740 740 7 7 7 7 7 7 740 740 740 740 7 7 7 7 7 7 7 7 7 7 218 98 
98 220 0 0 0 740 740 0 0 0 0 0 0 0 50 740 740 49 0 0 0 0 0 0 50 740 740 49 0 0 0 0 0 0 0 0 0 0 218 98 
98 220 0 0 0 740 740 0 0 0 0 0 0 0 50 740 740 49 0 0 0 0 0 0 50 740 740 49 0 0 0 0 0 0 0 0 0 0 218 98 
98 220 0 0 0 740 740 0 0 0 0 0 0 0 50 740 740 49 0 0 0 0 0 0 0 50 740 49 0 0 0 0 0 0 0 0 0 0 218 98 
98 220 0 0 0 7 7 0 0 0 0 0 0 0 50 740 740 49 0 0 0 0 0 0 0 50 740 49 0 0 0 0 0 0 0 0 0 0 218 98 
98 220 0 0 0 0 0 0 0 0 0 0 0 0 0 7 740 49 0 0 0 0 0 0 0 50 740 49 0 0 0 0 0 0 0 0 0 0 218 98 
98 220 0 0 0 0 0 0 0 0 0 0 0 0 0 0 7 0 0 0 0 0 0 0 0 50 740 49 0 0 0 0 0 0 0 0 0 0 218 98 
98 220 0 0 0 0 0 0 0 0 0 0 0 0 0 0 0 0 0 0 0 0 0 0 0 0 7 0 0 0 0 0 0 0 0 0 0 0 218 98 
98 220 0 0 0 0 0 0 0 0 0 0 0 0 0 0 0 0 0 0 0 0 0 0 0 0 0 0 0 0 0 0 0 0 0 0 0 0 218 98 
98 220 0 0 0 0 0 0 0 0 0 0 0 0 0 0 0 0 0 0 0 0 0 0 0 0 0 0 0 0 0 0 0 0 0 0 0 0 218 98 
259 260 0 0 0 0 0 0 0 0 0 0 0 0 0 0 0 0 0 0 0 0 0 0 0 0 0 0 0 0 0 0 0 6 0 0 0 0 218 98 
179 179 179 179 179 179 179 180 0 0 0 0 0 0 0 0 0 0 0 0 0 0 0 0 0 0 0 0 0 0 0 0 6 740 0 0 0 0 218 98 
98 98 98 98 98 98 98 220 0 0 0 0 0 0 0 0 0 0 0 0 0 0 0 0 0 0 0 0 0 0 0 6 740 740 0 0 0 0 218 98 
259 259 259 259 259 100 98 220 0 0 0 0 0 0 0 0 0 0 0 0 0 0 0 0 0 0 0 0 0 0 0 740 740 740 0 0 0 0 218 98 
740 740 740 740 740 218 98 220 0 0 0 0 0 0 0 0 0 0 0 0 0 0 0 0 0 0 0 0 0 0 0 740 740 740 0 0 0 0 218 98 
740 740 740 740 740 218 98 220 6 6 6 6 6 6 6 6 6 6 6 6 6 6 6 6 6 6 6 6 6 6 6 740 740 740 0 0 0 0 218 98 
179 179 179 179 179 140 98 220 178 179 179 179 179 179 179 179 179 179 179 179 179 179 179 179 179 179 179 179 179 179 179 179 179 180 0 0 0 0 218 98 
98 98 98 98 98 98 98 220 218 98 98 98 98 98 98 98 98 98 98 98 98 98 98 98 98 98 98 98 98 98 98 98 98 220 0 0 0 0 218 98 
259 259 259 259 259 259 259 260 258 259 259 259 259 259 259 259 259 259 259 259 259 259 259 259 259 259 259 259 259 259 259 259 259 260 0 0 0 0 258 259 
0 0 0 0 0 0 0 0 0 0 0 0 0 0 0 0 0 0 0 0 0 0 0 0 0 0 0 0 0 0 0 178 179 180 0 0 0 0 0 0 
0 0 0 0 0 0 0 0 0 0 0 0 0 0 0 0 0 0 0 0 0 0 0 0 0 0 0 0 0 0 0 218 98 220 0 0 0 0 0 0 
0 0 0 0 0 0 0 0 0 0 0 0 0 0 0 0 0 0 0 0 0 0 0 0 0 0 0 0 0 0 0 218 98 220 0 0 0 0 0 0 
0 0 0 0 0 0 0 0 0 0 0 0 0 0 0 0 0 0 0 0 0 0 0 0 0 0 0 0 0 0 0 258 259 260 0 0 0 0 0 0 
179 179 179 179 179 179 179 179 179 179 179 179 179 179 179 179 179 179 179 179 179 179 179 179 179 179 179 179 179 179 179 179 179 179 179 179 179 179 179 179 
98 98 98 98 98 98 98 98 98 98 98 98 98 98 98 98 98 98 98 98 98 98 98 98 98 98 98 98 98 98 98 98 98 98 98 98 98 98 98 98 
259 259 259 259 259 259 259 259 259 259 259 259 259 259 259 259 259 259 259 259 259 259 259 259 259 259 259 259 259 259 259 259 259 259 259 259 259 259 259 259 
740 740 740 740 740 740 740 740 740 740 740 740 740 740 740 740 740 740 740 740 740 740 740 740 740 740 740 740 740 740 740 740 740 740 740 740 740 740 740 740 
7
3 11 10 1
35 23 10 1
7 5 11 56
16 9 12 64
18 4 11 48
26 10 12 56
28 6 11 80
