740 740 740 740 740 740 740 740 740 740 740 740 740 740 740 740 740 740 740 740 740 740 740 740 740 740 740 740 740 740 740 740 740 740 740 740 740 740 740 740 
740 740 740 740 740 740 740 740 740 740 740 740 740 740 740 740 740 740 740 740 740 740 740 740 740 740 740 740 740 740 740 7 740 740 740 740 740 740 740 740 
740 740 740 740 740 740 7 740 740 740 740 740 740 740 740 740 740 740 740 740 740 740 740 740 740 740 740 740 740 740 7 0 7 740 740 740 740 740 740 740 
740 740 740 740 740 7 0 7 740 740 740 740 740 740 740 740 740 740 740 7 740 740 740 740 740 740 740 740 740 7 0 0 0 7 740 740 740 740 740 740 
740 740 740 740 7 0 0 0 7 740 740 740 740 740 740 740 740 740 7 0 7 740 740 740 740 740 740 740 7 0 0 0 0 0 7 740 740 740 740 740 
740 740 740 7 0 0 0 0 0 7 740 740 740 740 740 740 740 7 0 0 0 7 740 740 740 740 740 7 0 0 0 0 0 0 0 7 740 740 740 740 
740 740 7 0 0 0 0 0 0 0 7 740 740 740 740 740 7 0 0 0 0 0 7 740 740 740 7 0 0 0 0 0 0 0 0 0 7 740 740 740 
740 7 0 0 0 0 0 0 0 0 0 7 740 740 740 7 0 0 0 0 0 0 0 7 740 7 0 0 0 0 0 0 0 0 0 0 0 7 740 740 
7 0 0 0 0 0 0 0 0 0 0 0 7 740 7 0 0 0 0 0 0 0 0 0 7 0 0 0 0 0 0 0 0 0 0 0 0 0 7 7 
0 0 0 0 0 0 0 0 0 0 0 0 0 7 0 0 0 0 0 0 0 0 0 0 0 0 0 0 0 0 0 0 0 0 0 0 0 0 0 0 
0 0 0 0 0 0 0 0 0 0 0 0 0 0 0 0 0 0 0 0 0 0 0 0 0 0 0 0 0 0 0 0 0 0 0 0 0 0 0 0 
0 0 0 0 0 0 0 0 0 0 0 0 0 0 0 0 0 0 0 0 0 0 0 0 0 0 0 0 0 0 0 0 0 0 0 0 0 0 0 0 
0 0 0 0 0 0 0 0 0 0 0 0 0 0 0 0 0 0 0 0 0 0 0 0 0 0 0 0 0 0 0 0 0 0 0 0 0 0 0 0 
0 0 0 0 0 0 0 0 0 0 0 0 0 0 0 0 0 0 0 0 0 0 0 0 0 0 0 0 0 0 0 0 0 0 0 0 0 0 0 0 
0 0 0 0 0 0 0 0 0 0 0 0 0 0 0 0 0 0 0 0 0 0 0 0 0 0 0 0 0 0 0 0 0 0 0 0 0 0 0 0 
0 0 0 0 0 0 0 0 0 0 0 0 0 0 0 0 0 0 0 0 0 0 0 0 0 0 0 0 0 0 0 0 0 0 0 0 0 0 0 0 
0 0 0 0 0 0 0 0 0 0 0 0 0 0 0 0 0 0 0 0 0 0 0 0 0 0 0 0 0 0 0 0 0 0 0 0 0 0 0 0 
0 0 0 0 6 0 0 0 0 0 0 0 0 0 0 0 0 0 0 0 0 0 0 0 0 0 0 0 0 0 0 0 0 0 0 0 0 0 0 0 
0 0 0 6 740 6 0 0 0 0 0 0 0 0 0 0 0 0 0 0 0 0 0 0 0 0 0 0 0 0 0 0 0 0 0 0 0 0 0 0 
0 0 6 740 740 740 6 0 0 0 0 0 0 0 0 0 0 0 0 0 0 0 0 0 0 0 0 0 0 0 0 0 0 0 0 0 0 0 0 0 
6 6 740 740 740 740 740 6 0 0 0 0 0 0 0 0 0 0 0 0 0 0 0 0 0 0 0 0 0 0 0 0 0 0 0 0 0 0 0 6 
740 740 740 740 740 740 740 740 6 0 0 0 0 0 0 0 0 0 6 0 0 0 0 0 0 0 0 0 0 0 6 0 0 0 0 0 0 0 6 740 
740 740 740 740 740 740 740 740 740 6 0 0 0 0 0 0 0 6 740 6 0 0 0 0 0 0 0 0 0 6 740 6 0 0 0 0 0 6 740 740 
740 740 740 740 740 740 740 740 740 740 6 0 0 0 0 0 6 740 740 740 6 0 0 0 0 0 0 0 6 740 740 740 6 0 0 0 6 740 740 740 
740 740 740 740 740 740 740 740 740 740 740 6 0 0 0 6 740 740 740 740 740 6 0 0 0 0 0 6 740 740 740 740 740 6 0 6 740 740 740 740 
740 740 740 740 740 740 740 740 740 740 740 740 6 0 6 740 740 740 740 740 740 740 6 0 0 0 6 740 740 740 740 740 740 740 6 740 740 740 740 740 
740 740 740 740 740 740 740 740 740 740 740 740 740 6 740 740 740 740 740 740 740 740 740 6 0 6 740 740 740 740 740 740 740 740 740 740 740 740 740 740 
740 740 740 740 740 740 740 740 740 740 740 740 740 740 740 740 740 740 740 740 740 740 740 740 6 740 740 740 740 740 740 740 740 740 740 740 740 740 740 740 
740 740 740 740 740 740 740 740 740 740 740 740 740 740 740 740 740 740 740 740 740 740 740 740 740 740 740 740 740 740 740 740 740 740 740 740 740 740 740 740 
10
0 10 2 4 0 0 0 320 240
36 11 2 4 0 0 0 320 240
4 10 2 4 0 0 0 320 240
8 17 2 4 0 0 0 320 240
12 17 2 4 0 0 0 320 240
28 18 2 4 0 0 0 320 240
24 18 2 4 0 0 0 320 240
32 11 2 4 0 0 0 320 240
16 11 2 4 0 0 0 320 240
20 11 2 4 0 0 0 320 240
