295 295 295 295 295 417 0 0 0 0 0 0 415 295 295 295 295 295 295 295 295 295 295 295 295 295 295 295 295 295 295 295 295 295 295 295 295 295 295 295 
295 295 295 295 295 417 0 0 0 0 0 0 415 295 295 295 295 295 295 295 295 295 295 295 295 295 295 295 295 295 295 295 295 295 295 295 295 295 295 295 
295 295 295 295 295 417 0 0 0 0 0 0 455 456 456 456 456 456 456 456 456 456 456 456 297 295 295 296 456 456 456 456 456 456 456 456 456 456 456 456 
295 295 295 295 295 417 0 0 0 0 0 0 0 0 0 0 0 0 0 0 0 0 0 0 415 295 295 417 0 0 0 0 0 0 0 0 0 0 0 0 
295 295 295 295 295 417 0 0 0 0 0 0 0 0 0 0 0 0 0 0 0 0 0 0 415 295 295 417 0 0 0 0 0 0 0 0 0 0 0 0 
295 295 295 295 295 417 0 0 0 0 0 0 0 0 0 0 0 0 0 0 0 0 0 0 415 295 295 417 0 0 0 0 0 0 0 0 0 0 0 0 
295 295 295 295 295 417 0 0 0 0 0 0 0 0 0 0 0 0 0 0 0 0 0 0 455 456 456 457 0 0 0 0 0 0 0 0 0 0 0 0 
295 295 295 295 295 417 0 0 0 0 0 0 0 0 0 0 0 0 0 0 0 0 0 0 0 0 0 0 0 0 0 0 0 0 0 0 0 0 0 0 
295 295 295 295 295 417 0 0 0 0 0 0 0 0 0 0 0 0 0 0 0 0 0 0 0 0 0 0 0 0 0 0 0 0 0 0 0 0 0 0 
295 295 295 295 295 417 0 0 0 0 0 0 0 0 0 0 0 0 0 0 0 0 0 0 0 0 0 0 0 0 0 0 0 0 0 0 0 0 0 0 
295 295 295 295 295 417 0 0 0 0 0 0 375 376 377 0 0 0 0 0 0 0 0 0 0 0 0 0 0 0 0 0 0 0 0 0 0 0 0 0 
295 295 295 295 295 417 0 0 0 0 0 0 415 295 417 0 0 0 0 0 0 0 0 0 0 0 0 0 0 0 0 0 0 0 0 0 0 0 0 0 
295 295 295 295 295 417 0 0 0 0 0 0 415 295 417 0 0 0 0 0 0 0 0 0 0 0 0 0 0 0 0 0 0 0 0 0 0 0 0 0 
295 295 295 295 295 417 0 0 0 0 0 0 415 295 417 0 0 0 0 0 0 0 0 0 0 0 0 0 0 0 0 0 0 0 0 0 0 0 0 0 
295 295 295 295 295 417 0 0 0 0 0 0 415 295 417 0 0 0 0 0 0 0 0 0 0 0 0 0 0 0 0 0 0 0 0 0 0 0 0 0 
295 295 295 295 295 417 0 0 0 0 0 0 415 295 417 0 0 0 0 0 0 0 0 0 0 0 0 0 0 0 0 0 0 0 0 0 0 0 0 0 
295 295 295 295 295 417 0 0 0 0 0 0 415 295 417 0 0 0 0 0 0 0 0 0 0 0 0 0 0 0 0 0 0 0 0 0 0 0 0 0 
295 295 295 295 295 417 0 0 0 0 0 0 415 295 417 0 0 0 0 0 0 0 0 0 0 0 0 0 0 0 0 0 0 0 0 0 0 0 0 0 
295 295 295 295 295 417 0 0 0 0 0 0 415 295 417 0 0 0 0 0 0 0 0 0 0 0 0 0 0 0 0 0 0 0 0 0 0 0 0 0 
295 295 295 295 295 417 0 0 0 0 0 0 415 295 417 0 0 0 0 0 0 0 0 0 0 0 0 0 0 0 0 0 0 0 0 0 0 0 0 0 
295 295 295 295 295 417 0 0 0 0 0 0 415 295 417 0 0 0 0 0 0 0 0 0 0 0 0 0 0 0 0 0 0 0 0 0 0 0 0 0 
295 295 295 295 295 417 0 0 0 0 0 0 415 295 417 0 0 0 0 0 0 0 0 0 0 0 0 0 0 0 0 0 0 0 0 0 0 0 0 0 
295 295 295 295 295 417 0 0 0 0 0 0 415 295 417 0 0 0 0 0 0 0 0 0 0 0 0 0 0 0 0 0 0 0 0 0 0 0 0 0 
295 295 295 295 295 417 0 0 0 0 0 0 415 295 417 0 0 0 0 0 0 0 0 0 0 0 0 0 0 0 0 0 0 0 0 0 0 0 0 0 
295 295 295 295 295 417 0 0 0 0 0 0 415 295 417 0 0 0 0 0 0 0 0 0 0 0 0 0 0 0 0 0 0 0 0 0 0 0 0 0 
295 295 295 295 295 417 0 0 0 0 0 0 415 295 417 8 8 8 8 8 8 8 8 8 8 8 8 8 8 8 8 8 8 8 8 8 8 8 8 8 
295 295 295 295 295 336 376 376 376 376 376 376 337 295 336 376 376 376 376 376 376 376 376 376 376 376 376 376 376 376 376 376 376 376 376 376 376 376 376 376 
295 295 295 295 295 295 295 295 295 295 295 295 295 295 295 295 295 295 295 295 295 295 295 295 295 295 295 295 295 295 295 295 295 295 295 295 295 295 295 295 
295 295 295 295 295 295 295 295 295 295 295 295 295 295 295 295 295 295 295 295 295 295 295 295 295 295 295 295 295 295 295 295 295 295 295 295 295 295 295 295 
8
24 19 2
8 24 10
23 15 8
28 15 8
22 12 8
21 9 8
29 12 8
30 9 8
