286 286 408 686 686 686 686 686 686 808 0 0 0 0 0 0 0 0 0 0 0 0 0 0 0 0 0 806 686 686 686 686 686 686 686 686 686 406 286 286 
286 286 408 686 686 686 686 686 686 808 0 0 0 0 0 0 0 0 0 0 0 0 0 0 0 0 0 806 686 686 686 686 686 686 686 686 686 406 286 286 
286 286 408 686 686 686 686 686 686 808 0 0 0 0 0 0 0 0 0 0 0 0 0 0 0 0 0 806 686 686 686 686 686 686 686 686 686 406 286 286 
286 286 408 686 686 686 686 686 686 808 0 0 0 0 0 0 0 0 0 0 0 0 0 0 0 0 0 806 686 686 686 686 686 686 686 686 686 406 286 286 
286 286 408 686 686 686 686 686 686 808 0 0 0 0 0 0 0 0 0 0 0 0 0 0 0 0 0 806 686 686 686 686 686 686 686 686 686 406 286 286 
286 286 408 686 686 686 686 686 686 808 0 0 0 0 0 0 0 0 0 0 0 0 0 0 0 0 0 806 686 686 686 686 686 686 686 686 686 406 286 286 
286 286 408 686 686 686 686 686 686 808 0 0 0 0 0 0 0 0 0 0 0 0 0 0 0 0 0 806 686 686 686 686 686 686 686 686 686 406 286 286 
286 286 408 686 686 686 686 686 686 808 0 0 0 0 0 0 0 0 0 0 0 0 0 0 0 0 0 846 847 847 847 847 847 847 847 847 847 406 286 286 
286 286 408 686 686 686 686 686 686 808 0 0 0 0 0 0 0 0 0 0 0 0 0 0 0 0 0 0 0 0 0 0 0 0 0 0 0 406 286 286 
286 286 408 686 686 686 686 686 686 808 0 0 0 0 0 0 0 0 0 0 0 0 0 0 0 0 0 0 0 0 0 0 0 0 0 0 0 406 286 286 
286 286 408 686 686 686 686 686 686 808 0 0 0 0 0 0 0 0 0 0 0 0 0 0 0 0 0 0 0 0 0 0 0 0 0 0 0 406 286 286 
286 286 408 686 686 686 686 686 686 808 0 0 0 0 0 0 0 0 0 0 0 0 0 0 0 0 0 0 0 0 0 0 0 0 0 0 0 406 286 286 
447 447 448 686 686 686 686 686 686 808 0 0 0 0 0 0 0 0 0 0 0 0 0 0 0 0 0 0 0 0 0 0 0 0 0 0 0 406 286 286 
686 686 686 686 686 686 686 686 686 808 0 0 0 0 0 0 0 0 0 0 0 0 0 0 0 0 0 0 0 0 0 0 0 0 0 0 0 406 286 286 
686 686 686 686 686 686 686 686 686 808 0 0 0 0 0 0 0 0 0 0 0 0 0 0 0 0 0 0 0 0 0 0 0 0 0 0 0 406 286 286 
686 686 686 686 686 686 686 686 686 808 0 0 0 0 0 0 0 0 0 0 0 0 0 0 0 0 0 0 0 0 0 0 0 0 0 0 0 406 286 286 
686 686 686 686 686 686 686 686 686 808 0 0 0 0 0 0 0 0 0 0 0 0 0 0 0 0 0 0 0 0 0 0 0 0 0 0 0 406 286 286 
686 686 686 686 686 686 686 686 686 808 0 0 0 0 0 0 0 0 0 0 0 0 0 0 0 0 0 0 0 0 0 0 0 0 0 0 0 406 286 286 
686 686 686 686 686 686 686 686 686 808 0 0 0 0 0 0 0 0 0 0 0 0 0 0 0 0 0 0 366 367 367 367 368 0 0 0 0 406 286 286 
686 686 686 686 686 686 686 686 686 808 0 0 0 0 0 0 0 0 0 0 0 0 0 0 0 0 0 0 406 286 286 286 408 0 0 0 0 406 286 286 
686 686 686 686 686 686 686 686 686 808 0 0 0 0 0 0 0 0 0 0 0 0 0 0 0 0 0 0 406 286 286 286 408 0 0 0 0 406 286 286 
686 686 686 686 686 686 686 686 686 808 0 0 0 0 0 0 0 0 0 0 0 0 0 0 0 0 0 0 406 286 286 286 408 0 0 0 0 406 286 286 
686 686 686 686 686 686 686 686 686 808 0 0 0 0 0 0 0 0 0 0 0 0 0 0 0 0 0 0 406 286 286 286 408 0 0 0 0 406 286 286 
367 367 367 367 367 367 367 367 367 367 367 367 367 367 367 367 367 367 367 367 367 367 367 367 367 367 367 367 328 286 286 286 408 0 0 0 0 406 286 286 
286 286 286 286 286 286 286 286 286 286 286 286 286 286 286 286 286 286 286 286 286 286 286 286 286 286 286 286 286 286 286 286 408 0 0 0 0 406 286 286 
286 286 286 286 286 286 286 286 286 286 286 286 286 286 286 286 286 286 286 286 286 286 286 286 286 286 286 286 286 286 286 286 408 0 0 0 0 406 286 286 
286 286 286 286 286 286 286 286 286 286 286 286 286 286 286 286 286 286 286 286 286 286 286 286 286 286 286 286 286 286 286 286 408 0 0 0 0 406 286 286 
286 286 286 286 286 286 286 286 286 286 286 286 286 286 286 286 286 286 286 286 286 286 286 286 286 286 286 286 286 286 286 286 408 0 0 0 0 406 286 286 
286 286 286 286 286 286 286 286 286 286 286 286 286 286 286 286 286 286 286 286 286 286 286 286 286 286 286 286 286 286 286 286 408 0 0 0 0 406 286 286 
8
6 21 8
8 21 8
10 21 8
12 21 8
14 21 8
16 21 8
18 21 8
20 21 8
