489 489 489 489 489 489 489 489 611 686 686 686 686 686 686 686 686 686 686 686 686 686 686 686 686 686 686 686 686 686 686 686 686 686 686 686 686 609 489 489 
489 489 489 489 489 489 489 489 611 686 686 686 686 686 686 686 686 686 686 686 686 686 686 686 686 686 686 686 686 686 686 686 686 686 686 686 686 609 489 489 
489 489 489 489 489 489 489 489 611 686 686 686 686 686 686 686 686 686 686 686 686 686 686 686 686 686 686 686 686 686 686 686 686 686 686 686 686 609 489 489 
489 489 489 489 489 489 489 489 611 686 686 686 686 686 686 686 686 686 686 686 686 686 686 686 686 686 686 686 686 686 686 686 686 686 686 686 686 609 489 489 
489 489 489 489 489 489 489 489 611 686 686 686 686 686 686 686 686 686 686 686 686 686 686 686 686 686 687 847 847 847 847 847 847 847 688 686 686 609 489 489 
489 489 489 489 489 489 489 489 611 686 686 686 686 686 686 686 686 686 686 686 686 686 686 686 686 686 808 0 0 0 0 0 0 0 806 686 686 609 489 489 
489 489 489 489 489 489 489 489 611 686 686 686 686 686 686 686 686 686 686 686 686 686 686 686 686 686 808 0 0 0 0 0 0 0 806 686 686 609 489 489 
489 489 489 489 489 489 489 489 611 686 686 686 686 686 686 686 686 686 686 686 686 686 686 686 686 686 808 0 0 0 0 0 0 0 806 686 686 609 489 489 
489 489 489 489 489 489 489 489 611 686 686 686 686 686 686 686 686 686 686 686 686 686 686 686 686 686 808 0 0 0 0 0 0 0 806 686 686 609 489 489 
489 489 489 489 489 489 489 489 611 686 686 686 686 686 687 847 847 847 847 847 847 847 688 686 686 686 808 0 0 0 0 0 0 0 806 686 686 609 489 489 
489 489 489 489 489 489 489 489 611 686 686 686 686 686 808 0 0 0 0 0 0 0 806 686 686 686 727 767 767 767 767 767 767 767 728 686 686 609 489 489 
489 489 489 489 489 489 489 489 611 686 686 686 686 686 808 0 0 0 0 0 0 0 806 686 686 686 686 686 686 686 686 686 686 686 686 686 686 609 489 489 
489 489 489 489 489 489 489 489 611 686 686 686 686 686 808 0 0 0 0 0 0 0 806 686 686 686 686 686 686 686 686 686 686 686 686 686 686 609 489 489 
489 489 489 489 489 489 489 489 611 686 686 686 686 686 808 0 0 0 0 0 0 0 806 686 686 686 686 686 686 686 686 686 686 686 686 686 686 609 489 489 
489 489 489 489 489 489 489 489 611 686 686 686 686 686 808 0 0 0 0 0 0 0 806 686 686 686 686 686 686 686 686 686 686 686 686 686 686 609 489 489 
489 489 489 489 489 489 489 489 611 686 686 686 686 686 808 0 0 0 0 0 0 0 806 686 686 686 686 686 686 686 686 686 686 686 686 686 686 609 489 489 
489 489 489 489 489 489 489 489 611 686 686 686 686 686 808 0 0 0 0 0 0 0 806 686 686 686 686 686 686 686 686 686 686 686 686 686 686 609 489 489 
489 489 489 489 489 489 489 489 611 686 686 686 686 686 808 0 0 0 0 0 0 0 806 686 686 686 686 686 686 686 686 686 686 686 686 686 686 609 489 489 
489 489 489 489 489 489 489 489 611 686 686 686 686 686 808 0 0 0 0 0 0 0 806 686 686 686 686 686 686 686 686 686 686 686 686 686 686 609 489 489 
489 489 489 489 489 489 489 489 611 686 686 686 686 686 808 0 0 0 0 0 0 0 806 686 686 686 686 686 686 686 686 686 686 686 686 686 686 609 489 489 
489 489 489 489 489 489 489 489 611 686 686 686 686 686 727 767 767 767 767 767 767 767 728 686 686 686 686 686 686 686 686 686 686 686 686 686 686 609 489 489 
489 489 489 489 489 489 489 489 611 686 686 686 686 686 686 686 686 686 686 686 686 686 686 686 686 686 686 686 686 686 686 686 686 686 686 686 686 609 489 489 
489 489 489 489 489 489 489 489 611 686 686 686 686 686 686 686 686 686 686 686 686 686 686 686 686 686 686 686 686 686 686 686 686 686 686 686 686 609 489 489 
489 489 489 489 489 489 489 489 611 686 686 686 686 686 686 686 686 686 686 686 686 686 686 686 686 686 686 686 686 686 686 686 686 686 686 686 686 609 489 489 
489 489 489 489 489 489 489 489 611 686 686 686 686 686 686 686 686 686 686 686 686 686 686 686 686 686 686 686 686 686 687 847 847 847 847 847 847 609 489 489 
489 489 489 489 489 489 489 489 611 686 686 686 686 686 686 686 686 686 686 686 686 686 686 686 686 686 686 686 686 686 808 0 0 0 0 0 0 609 489 489 
489 489 489 489 489 489 489 489 611 686 686 686 686 686 686 686 686 686 686 686 686 686 686 686 686 686 686 686 686 686 808 0 0 0 0 0 0 609 489 489 
489 489 489 489 489 489 489 489 611 686 686 686 686 686 686 686 686 686 686 686 686 686 686 686 686 686 686 686 686 686 808 0 0 0 0 0 0 609 489 489 
489 489 489 489 489 489 489 489 611 686 686 686 686 686 686 686 686 686 686 686 686 686 686 686 686 686 686 686 686 686 808 0 0 0 0 0 0 609 489 489 
0
