292 292 292 292 292 292 292 292 414 698 698 698 698 698 698 698 820 0 0 0 0 0 0 0 0 0 0 0 0 0 0 0 0 0 0 0 0 412 292 292 
292 292 292 292 292 292 292 292 414 698 698 698 698 698 698 698 820 0 0 0 0 0 0 0 0 0 0 0 0 0 0 0 0 0 0 0 0 412 292 292 
453 453 453 453 453 453 453 453 454 698 698 698 698 698 698 698 820 0 0 0 0 0 0 0 0 0 0 0 0 0 0 0 0 0 0 0 0 412 292 292 
0 0 0 818 698 698 698 698 698 698 698 698 698 698 698 698 820 0 0 0 0 0 0 0 0 0 0 0 0 0 0 0 0 0 0 0 0 412 292 292 
0 0 0 818 698 698 698 698 698 698 698 698 698 698 698 698 820 0 0 0 0 0 0 0 0 0 0 0 0 0 0 0 0 0 0 0 0 412 292 292 
0 0 0 818 698 698 698 698 698 698 698 698 698 698 698 698 820 0 0 0 0 0 0 0 0 0 0 0 0 0 0 0 0 0 0 0 0 412 292 292 
0 0 0 818 698 698 698 698 698 698 698 698 698 698 698 698 820 0 0 0 0 0 0 0 0 0 778 779 779 779 779 779 779 779 779 779 779 412 292 292 
0 0 0 858 859 859 859 859 859 859 859 859 859 859 859 859 860 0 0 0 0 0 0 0 0 0 818 698 698 698 698 698 698 698 698 698 698 412 292 292 
0 0 0 0 0 0 0 0 0 0 0 0 0 0 0 0 0 0 0 0 0 0 0 0 0 0 818 698 698 698 698 698 698 698 698 698 698 412 292 292 
0 0 0 0 0 0 0 0 0 0 0 0 0 0 0 0 0 0 0 0 0 0 0 0 0 0 818 698 698 698 698 698 698 698 698 698 698 412 292 292 
0 0 0 0 0 0 0 0 0 0 0 0 0 0 0 0 0 0 0 0 0 0 0 0 0 0 818 698 698 698 698 698 698 698 698 698 698 412 292 292 
0 0 0 0 0 0 0 0 0 0 0 0 0 0 0 0 0 0 0 0 0 0 0 0 0 0 818 698 698 698 698 698 698 698 698 698 698 412 292 292 
0 0 0 0 0 0 0 0 0 0 0 0 0 0 0 0 0 0 0 0 0 0 0 0 0 0 818 698 698 698 698 698 698 698 698 698 698 412 292 292 
0 0 0 0 0 0 0 0 0 0 0 0 0 0 0 0 0 0 0 0 0 0 0 0 0 0 818 698 698 698 698 698 698 698 698 698 698 412 292 292 
0 0 0 0 0 0 0 0 0 0 0 0 0 0 0 0 0 0 0 0 0 0 0 0 0 0 818 698 698 698 698 698 698 698 698 698 698 412 292 292 
0 0 0 0 0 0 0 0 0 0 0 0 0 0 0 0 0 0 0 0 0 0 0 0 0 0 818 698 698 698 698 698 698 698 698 698 698 412 292 292 
0 0 0 0 0 0 0 0 0 0 0 0 0 0 0 0 0 0 0 0 0 0 0 0 0 0 818 698 698 698 698 698 698 698 698 698 698 412 292 292 
0 0 0 0 0 0 0 0 0 0 0 0 0 0 0 0 0 0 0 0 0 0 0 0 0 0 818 698 698 698 698 698 698 698 698 698 698 412 292 292 
0 0 0 0 0 0 0 0 0 0 0 0 0 0 0 0 0 0 0 0 0 0 0 0 0 0 818 698 698 698 698 698 698 698 698 698 698 412 292 292 
0 0 0 0 0 0 0 0 0 0 0 0 0 0 0 0 0 0 0 0 0 0 0 0 0 0 818 698 698 698 698 698 698 698 698 698 698 412 292 292 
0 0 0 0 0 0 0 0 0 0 0 0 0 0 0 0 0 0 0 0 0 0 0 0 0 0 818 698 698 698 698 698 698 698 698 698 698 412 292 292 
0 0 0 0 0 0 0 0 0 0 0 0 0 0 0 0 0 0 0 0 0 0 0 0 0 0 858 859 859 859 859 859 859 859 859 859 859 412 292 292 
0 0 0 0 0 0 0 0 0 0 0 0 0 0 0 0 0 0 0 0 0 0 0 0 0 0 0 0 0 0 0 0 0 0 0 0 0 412 292 292 
0 0 0 0 0 0 0 0 0 0 0 0 0 0 0 0 0 0 0 0 0 0 0 0 0 0 0 0 0 0 0 0 0 0 0 0 0 412 292 292 
0 0 0 0 0 0 0 0 0 0 0 0 0 0 0 0 0 0 0 0 0 0 0 0 0 0 0 0 0 0 0 0 0 0 0 0 0 412 292 292 
8 8 8 8 8 8 8 8 8 8 8 8 8 8 8 8 8 8 8 8 8 8 8 8 8 8 8 8 8 8 8 8 8 8 8 8 8 412 292 292 
373 373 373 373 373 373 373 373 373 373 373 373 373 373 373 373 373 373 373 373 373 373 373 373 373 373 373 373 373 373 373 373 373 373 373 373 373 334 292 292 
292 292 292 292 292 292 292 292 292 292 292 292 292 292 292 292 292 292 292 292 292 292 292 292 292 292 292 292 292 292 292 292 292 292 292 292 292 292 292 292 
292 292 292 292 292 292 292 292 292 292 292 292 292 292 292 292 292 292 292 292 292 292 292 292 292 292 292 292 292 292 292 292 292 292 292 292 292 292 292 292 
0
