492 492 492 492 492 492 492 492 492 492 492 492 492 492 492 492 492 492 492 492 492 492 492 492 492 492 492 492 492 492 492 492 492 492 492 492 492 492 492 492 
492 492 492 492 492 492 492 492 492 492 492 492 492 492 492 492 492 492 492 492 492 492 492 492 492 492 492 492 492 492 492 492 492 492 492 492 492 492 492 492 
492 492 492 492 492 492 492 492 492 492 492 492 492 492 492 492 492 492 492 492 492 492 492 492 492 492 492 492 492 492 492 492 492 492 492 492 492 492 492 492 
492 492 492 492 492 492 492 492 492 492 492 492 492 492 492 492 492 492 492 492 492 492 492 492 492 492 492 492 492 492 492 492 492 492 492 492 492 492 492 492 
492 492 492 492 492 492 492 492 492 492 492 492 492 492 492 492 492 492 492 492 492 492 492 492 492 492 492 492 492 492 492 492 492 492 492 492 492 492 492 492 
492 492 492 492 492 492 492 492 492 492 492 492 492 492 492 492 492 492 492 492 492 492 492 492 492 492 492 492 492 492 492 492 492 492 492 492 492 492 492 492 
492 492 492 492 492 492 492 492 492 492 492 492 492 492 492 492 492 492 492 492 492 492 492 492 492 492 492 492 492 492 492 492 492 492 492 492 492 492 492 492 
653 653 653 653 653 653 653 494 492 492 492 492 492 492 492 492 492 492 492 492 492 492 492 492 492 492 492 492 492 492 492 492 492 492 492 492 492 492 492 492 
7 7 7 7 7 7 7 612 492 492 492 492 492 492 492 492 492 492 492 492 492 492 492 492 492 492 492 492 492 492 492 492 492 492 492 492 492 492 492 492 
0 0 0 0 0 0 0 652 653 653 653 653 653 494 492 492 492 492 492 492 492 492 492 492 492 492 492 492 492 492 492 492 492 492 492 492 492 492 492 492 
0 0 0 0 0 0 0 0 692 0 0 0 0 612 492 492 492 492 492 492 492 492 492 492 492 492 492 492 492 492 492 492 492 492 492 492 492 492 492 492 
0 0 0 0 0 0 0 0 692 0 0 0 0 652 653 653 653 494 492 492 492 492 492 492 492 492 492 492 492 492 492 492 492 492 492 492 492 492 492 492 
0 0 0 0 0 0 0 0 692 0 0 0 0 0 692 0 0 612 492 492 492 492 492 492 492 492 492 492 492 492 492 492 492 492 492 492 492 492 492 492 
0 0 0 0 0 0 0 0 692 0 0 0 0 0 692 0 0 652 653 653 653 653 653 653 653 653 653 653 653 653 494 492 492 492 492 492 492 492 492 492 
0 0 0 0 0 0 0 0 692 0 0 0 0 0 692 0 0 0 0 0 692 0 0 0 692 0 0 0 0 0 612 492 492 492 492 492 492 492 492 492 
0 0 0 0 0 0 0 0 692 0 0 0 0 0 692 0 0 0 0 0 692 0 0 0 692 0 0 0 0 0 612 492 492 492 492 492 492 492 492 492 
0 0 0 0 0 0 0 0 692 0 0 0 0 0 692 0 0 0 0 0 692 0 0 0 692 0 0 0 0 0 612 492 492 492 492 492 492 492 492 492 
0 0 0 0 0 0 0 0 692 0 0 0 0 0 692 0 0 0 0 0 692 0 0 0 692 0 0 0 0 0 612 492 492 492 492 492 492 492 492 492 
0 0 0 0 0 0 0 0 692 0 0 0 0 0 692 0 0 0 0 0 692 0 0 0 572 573 573 573 573 573 534 492 492 492 492 492 492 492 492 492 
0 0 0 0 0 0 0 0 692 0 0 0 0 0 692 0 0 0 0 0 692 0 0 0 612 492 492 492 492 492 492 492 492 492 492 492 492 492 492 492 
0 0 0 0 0 0 0 0 692 0 0 0 0 0 692 0 572 573 573 573 573 573 573 573 534 492 492 492 492 492 492 492 492 492 492 492 492 492 492 492 
0 0 0 0 0 0 0 0 692 0 0 0 0 0 692 0 612 492 492 492 492 492 492 492 492 492 492 492 492 492 492 492 492 492 492 492 492 492 492 492 
0 0 0 0 0 0 0 0 692 0 0 0 0 0 572 573 534 492 492 492 492 492 492 492 492 492 492 492 492 492 492 492 492 492 492 492 492 492 492 492 
0 0 0 0 0 0 0 0 692 0 0 0 0 0 612 492 492 492 492 492 492 492 492 492 492 492 492 492 492 492 492 492 492 492 492 492 492 492 492 492 
573 573 573 573 573 573 573 573 573 573 573 573 573 573 534 492 492 492 492 492 492 492 492 492 492 492 492 492 492 492 492 492 492 492 492 492 492 492 492 492 
492 492 492 492 492 492 492 492 492 492 492 492 492 492 492 492 492 492 492 492 492 492 492 492 492 492 492 492 492 492 492 492 492 492 492 492 492 492 492 492 
492 492 492 492 492 492 492 492 492 492 492 492 492 492 492 492 492 492 492 492 492 492 492 492 492 492 492 492 492 492 492 492 492 492 492 492 492 492 492 492 
492 492 492 492 492 492 492 492 492 492 492 492 492 492 492 492 492 492 492 492 492 492 492 492 492 492 492 492 492 492 492 492 492 492 492 492 492 492 492 492 
492 492 492 492 492 492 492 492 492 492 492 492 492 492 492 492 492 492 492 492 492 492 492 492 492 492 492 492 492 492 492 492 492 492 492 492 492 492 492 492 
492 492 492 492 492 492 492 492 492 492 492 492 492 492 492 492 492 492 492 492 492 492 492 492 492 492 492 492 492 492 492 492 492 492 492 492 492 492 492 492 
1
26 15 9
