492 492 492 492 492 492 492 492 492 492 492 492 492 492 492 492 492 492 492 492 492 492 492 492 492 492 492 492 492 492 492 492 492 492 492 492 492 492 492 492 
492 492 493 653 653 653 653 653 653 653 653 653 653 653 653 653 653 653 653 653 653 653 653 653 653 653 653 653 653 653 494 492 493 653 653 653 653 494 492 492 
492 492 614 0 0 0 0 0 0 0 0 692 0 0 0 0 692 0 0 0 0 692 0 0 0 0 692 0 0 0 612 492 614 0 0 0 0 612 492 492 
492 492 614 0 0 0 0 0 0 0 0 692 0 0 0 0 692 0 0 0 0 692 0 0 0 0 692 0 0 0 612 492 614 0 0 0 0 612 492 492 
492 492 614 0 0 0 0 0 0 0 0 692 0 0 0 0 692 0 0 0 0 692 0 0 0 0 692 0 0 0 612 492 614 0 0 0 0 612 492 492 
492 492 614 0 0 0 0 0 0 0 0 692 0 0 0 0 692 0 0 0 0 692 0 0 0 0 692 0 0 0 612 492 614 0 0 0 0 612 492 492 
492 492 614 0 0 0 0 572 573 573 573 573 573 573 573 573 573 573 573 573 573 573 573 573 573 573 573 573 573 573 534 492 614 0 0 0 0 612 492 492 
492 492 614 693 693 693 693 612 492 492 492 492 492 492 492 492 492 492 492 492 492 492 492 492 492 492 492 492 492 492 492 492 614 693 693 693 693 612 492 492 
492 492 614 0 0 0 0 612 492 492 493 653 653 653 653 653 653 653 653 653 653 653 653 653 653 653 653 653 653 653 653 653 654 0 0 0 0 612 492 492 
492 492 614 0 0 0 0 612 492 492 614 0 0 0 0 692 0 0 0 0 692 0 0 0 0 692 0 0 0 0 692 0 0 0 0 0 0 612 492 492 
492 492 614 0 0 0 0 612 492 492 614 0 0 0 0 692 0 0 0 0 692 0 0 0 0 692 0 0 0 0 692 0 0 0 0 0 0 612 492 492 
492 492 614 0 0 0 0 612 492 492 614 0 0 0 0 692 0 0 0 0 692 0 0 0 0 692 0 0 0 0 692 0 0 0 0 0 0 612 492 492 
492 492 614 0 0 0 0 612 492 492 614 0 0 0 0 692 0 0 0 0 692 0 0 0 0 692 0 0 0 0 692 0 0 0 0 0 0 612 492 492 
492 492 614 0 0 0 0 612 492 492 533 573 573 573 573 573 573 573 573 573 573 573 573 573 573 573 573 573 573 573 573 573 573 573 573 573 573 534 492 492 
492 492 614 693 693 693 693 612 492 492 492 492 492 492 492 492 492 492 492 492 492 492 492 492 492 492 492 492 492 492 492 492 492 492 492 492 492 492 492 492 
492 492 614 0 0 0 0 652 653 653 653 653 653 653 653 653 653 653 653 653 653 653 653 653 494 492 493 653 653 653 653 653 653 653 653 653 653 494 492 492 
492 492 614 0 0 0 0 0 0 692 0 0 0 0 692 0 0 0 0 692 0 0 0 0 612 492 614 0 0 0 0 692 0 0 0 0 0 612 492 492 
492 492 614 0 0 0 0 0 0 692 0 0 0 0 692 0 0 0 0 692 0 0 0 0 612 492 614 0 0 0 0 692 0 0 0 0 0 612 492 492 
492 492 614 0 0 0 0 0 0 692 0 0 0 0 692 0 0 0 0 692 0 0 0 0 612 492 614 0 0 0 0 692 0 0 0 0 0 612 492 492 
492 492 614 0 0 0 0 0 0 692 0 0 0 0 692 0 0 0 0 692 0 0 0 0 612 492 614 0 0 0 0 692 0 0 0 0 0 612 492 492 
492 492 533 573 573 573 573 573 573 573 573 573 573 573 573 573 573 573 573 573 573 573 573 573 534 492 533 573 573 573 573 573 574 0 0 0 0 612 492 492 
492 492 492 492 492 492 492 492 492 492 492 492 492 492 492 492 492 492 492 492 492 492 492 492 492 492 492 492 492 492 492 492 614 693 693 693 693 612 492 492 
653 653 653 653 653 653 653 653 494 492 493 653 653 653 653 653 653 653 653 653 653 653 653 653 653 653 653 653 653 653 653 653 654 0 0 0 0 612 492 492 
0 0 0 692 0 0 0 0 612 492 614 0 0 0 0 0 0 692 0 0 0 0 0 692 0 0 0 0 0 692 0 0 0 0 0 0 0 612 492 492 
0 0 0 692 0 0 0 0 612 492 614 0 0 0 0 0 0 692 0 0 0 0 0 692 0 0 0 0 0 692 0 0 0 0 0 0 0 612 492 492 
0 0 0 692 0 0 0 0 612 492 614 0 0 0 0 0 0 692 0 0 0 0 0 692 0 0 0 0 0 692 0 0 0 0 0 0 0 612 492 492 
0 0 0 692 0 0 0 0 612 492 614 0 0 0 0 0 0 692 0 0 0 0 0 692 0 0 0 0 0 692 0 0 0 0 0 0 0 612 492 492 
573 573 573 573 573 573 573 573 534 492 533 573 573 573 573 573 573 573 573 573 573 573 573 573 573 573 573 573 573 573 573 573 573 573 573 573 573 534 492 492 
492 492 492 492 492 492 492 492 492 492 492 492 492 492 492 492 492 492 492 492 492 492 492 492 492 492 492 492 492 492 492 492 492 492 492 492 492 492 492 492 
492 492 492 492 492 492 492 492 492 492 492 492 492 492 492 492 492 492 492 492 492 492 492 492 492 492 492 492 492 492 492 492 492 492 492 492 492 492 492 492 
8
5 24 9
21 17 9
28 17 9
20 16 8
27 16 8
4 23 8
12 10 9
11 9 8
