101 101 101 101 101 101 101 101 101 101 101 101 101 101 101 101 101 101 101 101 101 101 101 101 101 101 101 101 101 101 101 101 101 101 101 101 101 101 101 101 
101 101 101 101 101 101 101 101 101 101 101 101 101 101 101 101 101 101 101 101 101 101 101 101 101 101 101 101 101 101 101 101 101 101 101 101 101 101 101 101 
101 101 101 101 101 101 101 101 101 101 101 101 101 101 101 101 101 101 101 101 101 101 101 101 101 101 101 101 101 101 101 101 101 101 101 101 101 101 101 101 
101 101 101 101 101 101 101 101 101 101 101 101 101 101 101 101 101 101 101 101 101 101 101 101 101 101 101 101 101 101 101 101 101 101 101 101 101 101 101 101 
262 262 262 262 262 262 262 262 262 262 262 262 262 262 262 262 262 262 262 262 262 262 262 262 262 262 262 262 262 262 262 262 262 262 262 262 262 262 262 262 
741 741 741 741 741 741 741 863 0 0 0 0 0 0 0 861 741 741 741 741 741 741 741 741 863 0 0 0 0 0 0 0 861 741 741 741 741 741 741 741 
741 741 741 741 741 741 741 863 0 0 0 0 0 0 0 861 741 742 902 902 902 902 743 741 863 0 0 0 0 0 0 0 861 741 741 741 741 741 741 741 
741 741 741 741 741 741 741 863 0 0 0 0 0 0 0 861 741 863 0 0 0 0 861 741 863 0 0 0 0 0 0 0 861 741 741 741 741 741 741 741 
741 741 741 741 741 741 741 863 0 0 0 0 0 0 0 861 741 863 0 0 0 0 861 741 863 0 0 0 0 0 0 0 861 741 741 741 741 741 741 741 
741 741 741 741 741 741 741 863 0 0 0 0 0 0 0 861 741 863 0 0 0 0 861 741 863 0 0 0 0 0 0 0 861 741 741 741 741 741 741 741 
741 741 741 741 741 741 741 863 0 0 0 0 0 0 0 861 741 782 822 822 822 822 783 741 863 0 0 0 0 0 0 0 861 741 741 741 741 741 741 741 
741 741 741 741 741 741 741 863 0 0 0 0 0 0 0 861 741 741 741 741 741 741 741 741 863 0 0 0 0 0 0 0 861 741 741 741 741 741 741 741 
741 741 741 741 741 741 741 181 182 182 182 182 182 182 182 182 182 182 182 182 182 182 182 182 182 182 182 182 182 182 182 182 183 741 741 741 741 741 741 741 
741 741 741 741 741 741 741 221 101 101 101 101 101 101 101 101 101 101 101 101 101 101 101 101 101 101 101 101 101 101 101 101 223 741 741 741 741 741 741 741 
741 741 741 741 741 741 741 221 101 101 101 101 101 101 101 101 101 101 101 101 101 101 101 101 101 101 101 101 101 101 101 101 223 741 741 741 741 741 741 741 
741 741 741 741 741 741 741 261 262 262 262 262 262 262 262 262 262 262 262 262 262 262 262 262 262 262 262 262 262 262 262 262 263 741 741 741 741 741 741 741 
741 741 741 741 741 741 741 741 741 741 741 741 741 741 741 741 741 741 741 741 741 741 741 741 741 741 741 741 741 741 741 741 741 741 741 741 741 741 741 741 
741 741 741 741 741 741 741 741 741 741 741 741 741 741 741 741 742 902 902 902 902 902 902 743 741 741 741 741 741 741 741 741 741 741 741 741 741 741 741 741 
741 741 741 742 902 902 902 902 902 902 902 902 902 743 741 741 863 0 0 0 0 0 0 861 741 741 742 902 902 902 902 902 902 902 902 902 743 741 741 741 
741 741 741 863 0 0 0 0 0 0 0 0 0 861 741 741 863 0 0 0 0 0 0 861 741 741 863 0 0 0 0 0 0 0 0 0 861 741 741 741 
741 741 741 863 0 0 0 0 0 0 0 0 0 861 741 741 863 0 0 0 0 0 0 861 741 741 863 0 0 0 0 0 0 0 0 0 861 741 741 741 
741 741 741 863 0 0 0 0 0 0 0 0 0 861 741 741 863 0 0 0 0 0 0 861 741 741 863 0 0 0 0 0 0 0 0 0 861 741 741 741 
741 741 741 782 822 822 822 822 822 822 822 822 822 783 741 741 863 0 0 0 0 0 0 861 741 741 782 822 822 822 822 822 822 822 822 822 783 741 741 741 
741 741 741 741 741 741 741 741 741 741 741 741 741 741 741 741 782 822 822 822 822 822 822 783 741 741 741 741 741 741 741 741 741 741 741 741 741 741 741 741 
741 741 741 741 741 741 741 741 741 741 741 741 741 741 741 741 741 741 741 741 741 741 741 741 741 741 741 741 741 741 741 741 741 741 741 741 741 741 741 741 
182 182 182 182 182 182 182 182 182 182 182 182 182 182 182 182 183 741 741 741 741 741 741 181 182 182 182 182 182 182 182 182 182 182 182 182 182 182 182 182 
101 101 101 101 101 101 101 101 101 101 101 101 101 101 101 101 223 741 741 741 741 741 741 221 101 101 101 101 101 101 101 101 101 101 101 101 101 101 101 101 
101 101 101 101 101 101 101 101 101 101 101 101 101 101 101 101 223 741 741 741 741 741 741 221 101 101 101 101 101 101 101 101 101 101 101 101 101 101 101 101 
101 101 101 101 101 101 101 101 101 101 101 101 101 101 101 101 223 741 741 741 741 741 741 221 101 101 101 101 101 101 101 101 101 101 101 101 101 101 101 101 
101 101 101 101 101 101 101 101 101 101 101 101 101 101 101 101 223 741 741 741 741 741 741 221 101 101 101 101 101 101 101 101 101 101 101 101 101 101 101 101 
4
27 10 10 1
22 10 10 1
11 10 10 1
16 10 10 1
