107 107 107 107 107 107 107 107 107 107 107 107 107 107 107 107 229 747 748 908 908 749 747 227 107 107 107 107 107 107 107 107 107 107 107 107 107 107 107 107 
107 107 107 107 107 107 107 107 107 107 107 107 107 107 107 107 229 747 869 0 0 867 747 227 107 107 107 107 107 107 107 107 107 107 107 107 107 107 107 107 
107 107 107 107 107 107 107 107 107 107 107 107 107 107 107 107 229 747 869 0 0 867 747 227 107 107 107 107 107 107 107 107 107 107 107 107 107 107 107 107 
107 107 107 107 107 107 107 107 107 107 107 107 107 107 107 107 229 747 788 828 828 789 747 227 107 107 107 107 107 107 107 107 107 107 107 107 107 107 107 107 
107 107 107 107 107 107 107 107 107 107 107 107 107 107 107 107 229 747 747 747 747 747 747 227 107 107 107 107 107 107 107 107 107 107 107 107 107 107 107 107 
268 268 268 268 268 268 268 268 268 268 268 109 107 107 107 107 229 747 748 908 908 749 747 227 107 107 107 107 108 268 268 268 268 268 268 268 268 268 268 268 
747 747 747 747 747 747 747 747 747 747 747 227 107 107 107 107 229 747 869 0 0 867 747 227 107 107 107 107 229 747 747 747 747 747 747 747 747 747 747 747 
747 747 747 747 747 747 747 747 747 747 747 227 107 107 107 107 229 747 869 0 0 867 747 227 107 107 107 107 229 747 747 747 747 747 747 747 747 747 747 747 
747 747 747 747 747 747 747 747 747 747 747 227 107 107 107 107 229 747 788 828 828 789 747 227 107 107 107 107 229 747 747 747 747 747 747 747 747 747 747 747 
747 747 747 747 747 747 747 747 747 747 747 267 268 268 268 268 269 747 747 747 747 747 747 267 268 268 268 268 269 747 747 747 747 747 747 747 747 747 747 747 
747 747 747 747 747 747 747 747 747 747 747 747 747 747 747 747 747 747 748 908 908 749 747 747 747 747 747 747 747 747 747 747 747 747 747 747 747 747 747 747 
747 747 747 747 747 747 747 747 747 747 747 747 747 747 748 908 908 749 869 0 0 867 748 908 908 749 747 747 747 747 747 747 747 747 747 747 747 747 747 747 
747 747 747 747 747 747 747 747 747 747 748 908 908 749 869 0 0 867 869 0 0 867 869 0 0 867 748 908 908 749 747 747 747 747 747 747 747 747 747 747 
747 747 747 747 747 747 747 747 747 747 869 0 0 867 869 0 0 867 788 828 828 789 869 0 0 867 869 0 0 867 747 747 747 747 747 747 747 747 747 747 
747 747 747 747 747 747 747 747 747 747 869 0 0 867 788 828 828 789 747 747 747 747 788 828 828 789 869 0 0 867 747 747 747 747 747 747 747 747 747 747 
747 747 747 747 747 747 747 747 747 747 788 828 828 789 747 747 747 747 747 747 747 747 747 747 747 747 788 828 828 789 747 747 747 747 747 747 747 747 747 747 
747 747 747 747 747 747 187 188 188 188 188 188 188 188 188 188 188 188 188 188 188 188 188 188 188 188 188 188 188 188 188 188 188 189 747 747 747 747 747 747 
747 747 747 747 747 747 227 107 107 107 107 107 107 107 107 107 107 107 107 107 107 107 107 107 107 107 107 107 107 107 107 107 107 229 747 747 747 747 747 747 
747 747 747 747 747 747 267 268 268 268 268 268 268 268 268 268 268 268 268 268 268 268 268 268 268 268 268 268 268 268 268 268 268 269 747 747 747 747 747 747 
747 747 747 747 747 747 747 747 747 747 747 747 747 747 747 747 747 747 747 747 747 747 747 747 747 747 747 747 747 747 747 747 747 747 747 747 747 747 747 747 
747 747 747 747 747 747 747 747 747 747 748 908 908 908 908 908 908 908 908 908 908 908 908 908 908 908 908 908 908 749 747 747 747 747 747 747 747 747 747 747 
747 747 747 747 747 747 747 747 747 747 869 0 0 0 0 0 0 0 0 0 0 0 0 0 0 0 0 0 0 867 747 747 747 747 747 747 747 747 747 747 
747 747 747 747 747 747 747 747 747 747 869 0 0 0 0 0 0 0 0 0 0 0 0 0 0 0 0 0 0 867 747 747 747 747 747 747 747 747 747 747 
747 747 747 747 747 747 747 747 747 747 788 828 828 828 828 828 828 828 828 828 828 828 828 828 828 828 828 828 828 789 747 747 747 747 747 747 747 747 747 747 
747 747 747 747 747 747 747 747 747 747 747 747 747 747 747 747 747 747 747 747 747 747 747 747 747 747 747 747 747 747 747 747 747 747 747 747 747 747 747 747 
188 188 188 188 188 188 188 188 188 188 188 188 188 188 188 188 188 188 188 188 188 188 188 188 188 188 188 188 188 188 188 188 188 188 188 188 188 188 188 188 
107 107 107 107 107 107 107 107 107 107 107 107 107 107 107 107 107 107 107 107 107 107 107 107 107 107 107 107 107 107 107 107 107 107 107 107 107 107 107 107 
107 107 107 107 107 107 107 107 107 107 107 107 107 107 107 107 107 107 107 107 107 107 107 107 107 107 107 107 107 107 107 107 107 107 107 107 107 107 107 107 
107 107 107 107 107 107 107 107 107 107 107 107 107 107 107 107 107 107 107 107 107 107 107 107 107 107 107 107 107 107 107 107 107 107 107 107 107 107 107 107 
107 107 107 107 107 107 107 107 107 107 107 107 107 107 107 107 107 107 107 107 107 107 107 107 107 107 107 107 107 107 107 107 107 107 107 107 107 107 107 107 
0
