116 116 116 116 116 116 116 116 116 116 116 116 116 116 116 116 116 116 116 116 116 116 116 116 116 116 116 116 116 116 116 116 116 116 116 116 116 116 116 116 
116 116 116 116 116 116 116 116 116 116 116 116 116 116 116 116 116 116 116 116 116 116 116 116 116 116 116 116 116 116 116 116 116 116 116 116 116 116 116 116 
116 116 116 116 116 116 116 116 116 116 116 116 116 116 116 116 116 116 116 116 116 116 116 116 116 116 116 116 116 116 116 116 116 116 116 116 116 116 116 116 
116 116 116 116 116 116 116 116 116 116 116 116 116 116 116 116 116 116 116 116 116 116 116 116 116 116 116 116 116 116 116 116 116 116 116 116 116 116 116 116 
116 116 116 116 116 116 116 116 116 116 116 116 116 116 116 116 116 116 116 116 116 116 116 116 116 116 116 116 116 116 116 116 116 116 116 116 116 116 116 116 
277 277 277 277 277 277 277 277 277 277 277 277 277 277 277 277 277 277 277 277 277 277 277 277 277 277 277 277 118 116 116 116 116 116 116 116 116 116 116 116 
756 756 756 756 756 756 756 756 756 756 756 756 756 756 756 756 756 756 756 756 756 756 756 756 756 756 756 756 236 116 116 116 116 116 116 116 116 116 116 116 
756 756 756 756 756 756 756 756 756 756 756 756 756 756 756 756 756 756 756 756 756 756 756 756 756 756 756 756 236 116 116 116 116 116 116 116 116 116 116 116 
756 756 756 756 757 917 917 917 917 758 756 756 757 917 917 917 917 758 756 756 757 917 917 917 917 758 756 756 236 116 116 116 116 116 116 116 116 116 116 116 
756 756 756 756 878 0 0 0 0 876 756 756 878 0 0 0 0 876 756 756 878 0 0 0 0 876 756 756 236 116 116 116 116 116 116 116 116 116 116 116 
756 756 756 756 878 0 0 0 0 876 756 756 878 0 0 0 0 876 756 756 878 0 0 0 0 876 756 756 236 116 116 116 116 116 116 116 116 116 116 116 
756 756 756 756 878 0 0 0 0 876 756 756 878 0 0 0 0 876 756 756 878 0 0 0 0 876 756 756 236 116 116 116 116 116 116 116 116 116 116 116 
756 756 756 756 878 0 0 0 0 876 756 756 878 0 0 0 0 876 756 756 878 0 0 0 0 876 756 756 236 116 116 116 116 116 116 116 116 116 116 116 
756 756 756 756 878 0 0 0 0 876 756 756 878 0 0 0 0 876 756 756 878 0 0 0 0 876 756 756 236 116 116 116 116 116 116 116 116 116 116 116 
756 756 756 756 878 0 0 0 0 876 756 756 878 0 0 0 0 876 756 756 878 0 0 0 0 876 756 756 236 116 116 116 116 116 116 116 116 116 116 116 
756 756 756 756 878 0 0 0 0 876 756 756 797 837 837 837 837 798 756 756 878 0 0 0 0 876 756 756 236 116 116 116 116 116 116 116 116 116 116 116 
756 756 756 756 878 0 0 0 0 876 756 756 756 756 756 756 756 756 756 756 878 0 0 0 0 876 756 756 236 116 116 116 116 116 116 116 116 116 116 116 
756 756 756 756 878 0 0 0 0 876 756 756 756 756 756 756 756 756 756 756 878 0 0 0 0 876 756 756 236 116 116 116 116 116 116 116 116 116 116 116 
756 756 756 756 878 0 0 0 0 876 756 756 196 197 197 197 197 198 756 756 878 0 0 0 0 876 756 756 236 116 116 116 116 116 116 116 116 116 116 116 
756 756 756 756 878 0 0 0 0 876 756 756 236 116 116 116 116 238 756 756 878 0 0 0 0 876 756 756 236 116 116 116 116 116 116 116 116 116 116 116 
756 756 756 756 878 0 0 0 0 876 756 756 236 116 116 116 116 238 756 756 878 0 0 0 0 876 756 756 236 116 116 116 116 116 116 116 116 116 116 116 
756 756 756 756 878 0 0 0 0 876 756 756 236 116 116 116 116 238 756 756 878 0 0 0 0 876 756 756 236 116 116 116 116 116 116 116 116 116 116 116 
756 756 756 756 797 837 837 837 837 798 756 756 236 116 116 116 116 238 756 756 797 837 837 837 837 798 756 756 236 116 116 116 116 116 116 116 116 116 116 116 
756 756 756 756 756 756 756 756 756 756 756 756 236 116 116 116 116 238 756 756 756 756 756 756 756 756 756 756 236 116 116 116 116 116 116 116 116 116 116 116 
756 756 756 756 756 756 756 756 756 756 756 756 236 116 116 116 116 238 917 917 758 756 756 756 756 757 917 917 236 116 116 116 116 116 116 116 116 116 116 116 
197 197 197 197 197 197 197 197 197 197 197 197 158 116 116 116 116 238 0 0 876 756 756 756 756 878 0 0 236 116 116 116 116 116 116 116 116 116 116 116 
116 116 116 116 116 116 116 116 116 116 116 116 116 116 116 116 116 238 0 0 916 917 917 917 917 918 0 0 236 116 116 116 116 116 116 116 116 116 116 116 
116 116 116 116 116 116 116 116 116 116 116 116 116 116 116 116 116 238 0 0 0 0 0 0 0 0 0 0 236 116 116 116 116 116 116 116 116 116 116 116 
116 116 116 116 116 116 116 116 116 116 116 116 116 116 116 116 116 238 0 0 0 0 0 0 0 0 0 0 236 116 116 116 116 116 116 116 116 116 116 116 
116 116 116 116 116 116 116 116 116 116 116 116 116 116 116 116 116 238 0 0 0 0 0 0 0 0 0 0 236 116 116 116 116 116 116 116 116 116 116 116 
0
