483 483 483 483 483 483 483 483 483 483 483 483 483 483 483 483 483 605 0 0 0 0 603 483 483 483 483 483 483 483 483 483 483 483 483 483 483 483 483 483 
483 483 483 483 483 483 483 483 483 483 483 483 483 483 483 483 483 605 0 0 0 0 603 483 483 483 483 483 483 483 483 483 483 483 483 483 483 483 483 483 
483 483 483 483 483 483 483 483 483 483 483 483 483 483 483 483 483 605 0 0 0 0 603 483 483 483 483 483 483 483 483 483 483 483 483 483 483 483 483 483 
483 483 483 483 483 483 483 483 483 483 483 483 483 483 483 483 483 605 0 0 0 0 603 483 483 483 483 483 483 483 483 483 483 483 483 483 483 483 483 483 
483 483 483 483 483 483 483 483 483 483 483 483 483 483 483 483 483 605 0 0 0 0 603 483 483 483 483 483 483 483 483 483 483 483 483 483 483 483 483 483 
483 483 483 483 483 483 483 483 483 483 483 483 483 483 483 483 483 605 0 0 0 0 603 483 483 483 483 483 483 483 483 483 483 483 483 483 483 483 483 483 
483 483 483 483 483 483 483 483 483 483 483 483 483 483 483 483 483 605 0 0 0 0 643 644 644 644 644 644 644 644 644 644 644 644 644 644 644 644 644 644 
483 483 483 483 483 483 483 483 483 483 483 483 483 483 483 483 483 605 0 0 0 0 0 0 0 0 0 0 0 0 0 0 0 0 0 0 0 0 0 0 
483 483 483 483 483 483 483 483 483 483 483 483 483 483 483 483 483 605 0 0 0 0 0 0 0 0 0 0 0 0 0 0 0 0 0 0 0 0 0 0 
483 483 483 483 483 483 483 483 483 483 483 483 483 483 483 483 483 605 0 0 0 0 0 0 0 0 0 0 0 0 0 0 0 0 0 0 0 0 0 0 
483 483 483 483 483 483 483 483 483 483 483 483 483 483 483 483 483 605 0 0 0 0 0 0 0 0 0 0 0 0 0 0 0 0 0 0 0 0 0 0 
483 483 483 483 483 483 483 483 483 483 483 483 483 483 483 483 483 605 0 0 0 0 0 0 0 0 0 0 0 0 0 0 0 0 0 0 0 0 0 0 
483 483 483 483 483 483 483 483 483 483 483 483 483 483 483 483 483 605 0 0 0 0 0 0 0 0 0 0 0 0 0 0 0 0 0 0 0 0 0 0 
483 483 483 483 483 483 483 483 483 483 483 483 483 483 483 483 483 605 0 0 0 0 0 0 0 0 0 0 0 0 0 0 0 0 0 0 0 0 0 0 
483 483 483 483 483 483 483 483 483 483 483 483 483 483 483 483 483 605 0 0 0 0 0 0 0 0 0 0 0 0 0 0 0 0 0 0 0 0 0 0 
483 483 483 483 483 483 483 483 483 483 483 483 483 483 483 483 483 605 0 0 0 0 0 0 0 0 0 0 0 0 0 0 0 0 0 0 0 0 0 0 
483 483 483 483 483 483 483 483 483 483 483 483 483 483 483 483 483 605 0 0 0 0 0 0 0 0 0 0 0 0 0 0 0 0 0 0 0 0 0 0 
483 483 483 483 483 483 483 483 483 483 483 483 483 483 483 483 483 605 0 0 0 0 0 0 0 0 0 0 0 0 0 0 0 0 0 0 0 0 0 0 
483 483 483 483 483 483 483 483 483 483 483 483 483 483 483 483 483 524 564 564 564 564 564 564 564 564 564 564 564 564 564 564 564 564 564 564 564 564 564 564 
483 483 483 483 483 483 483 483 483 483 483 483 483 483 483 483 483 483 483 483 483 483 483 483 483 483 483 483 483 483 483 483 483 483 483 483 483 483 483 483 
483 483 483 483 483 483 483 483 483 483 483 483 483 483 483 483 483 483 483 483 483 483 483 483 483 483 483 483 483 483 483 483 483 483 483 483 483 483 483 483 
483 483 483 483 483 483 483 483 483 483 483 483 483 483 483 483 483 483 483 483 483 483 483 483 483 483 483 483 483 483 483 483 483 483 483 483 483 483 483 483 
483 483 483 483 483 483 483 483 483 483 483 483 483 483 483 483 483 483 483 483 483 483 483 483 483 483 483 483 483 483 483 483 483 483 483 483 483 483 483 483 
483 483 483 483 483 483 483 483 483 483 483 483 483 483 483 483 483 483 483 483 483 483 483 483 483 483 483 483 483 483 483 483 483 483 483 483 483 483 483 483 
483 483 483 483 483 483 483 483 483 483 483 483 483 483 483 483 483 483 483 483 483 483 483 483 483 483 483 483 483 483 483 483 483 483 483 483 483 483 483 483 
483 483 483 483 483 483 483 483 483 483 483 483 483 483 483 483 483 483 483 483 483 483 483 483 483 483 483 483 483 483 483 483 483 483 483 483 483 483 483 483 
483 483 483 483 483 483 483 483 483 483 483 483 483 483 483 483 483 483 483 483 483 483 483 483 483 483 483 483 483 483 483 483 483 483 483 483 483 483 483 483 
483 483 483 483 483 483 483 483 483 483 483 483 483 483 483 483 483 483 483 483 483 483 483 483 483 483 483 483 483 483 483 483 483 483 483 483 483 483 483 483 
483 483 483 483 483 483 483 483 483 483 483 483 483 483 483 483 483 483 483 483 483 483 483 483 483 483 483 483 483 483 483 483 483 483 483 483 483 483 483 483 
483 483 483 483 483 483 483 483 483 483 483 483 483 483 483 483 483 483 483 483 483 483 483 483 483 483 483 483 483 483 483 483 483 483 483 483 483 483 483 483 
0
