492 492 492 492 492 492 492 492 492 492 492 492 492 492 492 492 492 492 492 492 492 492 492 492 492 492 492 492 492 492 492 492 492 492 492 492 492 492 492 492 
492 492 492 492 492 492 492 492 492 492 492 492 492 492 492 492 492 492 492 492 492 492 492 492 492 492 492 492 492 492 492 492 492 492 492 492 492 492 492 492 
492 492 492 492 492 492 492 492 492 492 492 492 492 492 492 492 492 492 492 492 492 492 492 492 492 492 492 492 492 492 492 492 492 492 492 492 492 492 492 492 
492 492 492 492 492 492 492 492 492 492 492 492 492 492 492 492 492 492 492 492 492 492 492 492 492 492 492 492 492 492 492 492 492 492 492 492 492 492 492 492 
492 492 492 492 492 492 492 492 492 492 492 492 492 492 492 492 492 492 492 492 492 492 492 492 492 492 492 492 492 492 492 492 492 492 492 492 492 492 492 492 
492 492 492 492 492 492 492 492 492 492 492 492 492 492 492 492 492 492 492 492 492 492 492 492 492 492 492 492 492 492 492 492 492 492 492 492 492 492 492 492 
492 492 492 492 492 492 492 492 492 492 492 492 492 492 492 492 492 492 492 492 492 492 492 492 492 492 492 492 492 492 492 492 492 492 492 492 492 492 492 492 
653 653 653 653 653 653 653 653 653 653 653 653 653 653 653 653 653 653 653 653 653 653 653 653 494 492 492 492 492 492 492 492 492 492 492 492 492 492 492 492 
0 0 0 0 0 0 0 0 0 0 0 0 0 0 0 0 0 0 0 0 0 0 0 0 612 492 492 492 492 492 492 492 492 492 492 492 492 492 492 492 
0 0 0 0 0 0 0 0 0 0 0 0 0 0 0 0 0 0 0 0 0 0 0 0 612 492 492 492 492 492 492 492 492 492 492 492 492 492 492 492 
0 0 0 0 0 0 0 0 0 0 0 0 0 0 0 0 0 0 0 0 0 0 0 0 612 492 492 492 492 492 492 492 492 492 492 492 492 492 492 492 
0 0 0 0 0 0 0 0 0 0 0 0 0 0 0 0 0 0 0 0 0 0 0 0 612 492 492 492 492 492 492 492 492 492 492 492 492 492 492 492 
0 0 0 0 0 0 0 0 0 0 0 0 0 0 0 0 0 0 0 0 0 0 0 0 612 492 492 492 492 492 492 492 492 492 492 492 492 492 492 492 
0 0 0 0 0 0 0 0 0 0 0 0 0 0 0 0 0 0 0 0 0 0 0 0 612 492 492 492 492 492 492 492 492 492 492 492 492 492 492 492 
0 0 0 0 0 0 0 0 0 0 0 0 0 0 0 0 0 0 0 0 0 0 0 0 612 492 492 492 492 492 492 492 492 492 492 492 492 492 492 492 
0 0 0 0 0 0 0 0 0 0 0 0 0 0 0 0 0 0 0 0 0 0 0 0 612 492 492 492 492 492 492 492 492 492 492 492 492 492 492 492 
0 0 0 0 0 0 0 0 0 0 0 0 0 0 0 0 0 0 0 0 0 0 0 0 612 492 492 492 492 492 492 492 492 492 492 492 492 492 492 492 
0 0 0 0 0 0 0 0 0 0 0 0 0 0 0 0 0 0 0 0 0 0 0 0 612 492 492 492 492 492 492 492 492 492 492 492 492 492 492 492 
0 0 0 0 0 0 0 0 0 0 0 0 0 0 0 0 0 0 0 0 0 0 0 0 612 492 492 492 492 492 492 492 492 492 492 492 492 492 492 492 
0 0 0 0 0 0 0 0 0 572 573 573 573 573 573 574 0 0 0 0 0 0 0 0 612 492 492 492 492 492 492 492 492 492 492 492 492 492 492 492 
0 0 0 0 0 0 0 0 0 612 492 492 492 492 492 614 0 0 0 0 0 0 0 0 612 492 492 492 492 492 492 492 492 492 492 492 492 492 492 492 
0 0 0 0 0 0 0 0 0 612 492 492 492 492 492 614 0 0 0 0 0 0 0 0 612 492 492 492 492 492 492 492 492 492 492 492 492 492 492 492 
0 0 0 0 0 0 0 0 0 612 492 492 492 492 492 614 0 0 0 0 0 0 0 0 612 492 492 492 492 492 492 492 492 492 492 492 492 492 492 492 
0 0 0 0 0 0 0 0 0 612 492 492 492 492 492 614 0 0 0 0 0 0 0 0 612 492 492 492 492 492 492 492 492 492 492 492 492 492 492 492 
0 0 0 0 0 0 0 0 0 612 492 492 492 492 492 614 0 0 0 0 0 0 0 0 612 492 492 492 492 492 492 492 492 492 492 492 492 492 492 492 
0 0 0 0 0 0 0 0 0 612 492 492 492 492 492 614 0 0 0 0 0 0 0 0 612 492 492 492 492 492 492 492 492 492 492 492 492 492 492 492 
6 6 6 6 6 6 6 6 6 612 492 492 492 492 492 614 0 0 0 0 0 0 0 0 612 492 492 492 492 492 492 492 492 492 492 492 492 492 492 492 
573 573 573 573 573 573 573 573 573 534 492 492 492 492 492 614 0 0 0 0 0 0 0 0 612 492 492 492 492 492 492 492 492 492 492 492 492 492 492 492 
492 492 492 492 492 492 492 492 492 492 492 492 492 492 492 614 0 0 0 0 0 0 0 0 612 492 492 492 492 492 492 492 492 492 492 492 492 492 492 492 
492 492 492 492 492 492 492 492 492 492 492 492 492 492 492 614 0 0 0 0 0 0 0 0 612 492 492 492 492 492 492 492 492 492 492 492 492 492 492 492 
0
