316 316 316 316 316 316 316 316 316 316 316 316 316 316 316 316 316 316 316 316 316 316 438 403 283 283 283 283 283 283 283 283 283 283 283 283 283 283 283 283 
316 316 316 316 316 316 316 316 316 316 316 316 316 316 316 316 316 316 316 316 316 316 438 403 283 283 283 283 283 283 283 283 283 283 283 283 283 283 283 283 
316 316 316 316 316 316 316 316 316 316 316 316 316 316 316 316 316 316 316 316 316 316 438 443 285 283 283 283 283 283 283 283 283 283 283 283 283 283 283 283 
316 316 316 316 316 316 316 316 316 316 316 316 316 316 316 316 316 316 316 316 316 316 357 398 403 283 283 283 283 283 283 283 283 283 283 283 283 283 283 283 
316 316 316 316 316 316 316 316 316 316 316 316 316 316 316 316 316 316 316 316 316 316 316 438 403 283 283 283 283 283 283 283 283 283 283 283 283 283 283 283 
316 316 316 316 316 316 316 316 316 316 316 316 316 316 316 316 316 316 316 316 316 316 316 438 403 283 283 283 283 283 283 283 283 283 283 283 283 283 283 283 
316 316 316 316 316 316 316 316 316 316 316 316 316 316 316 316 316 316 316 316 316 316 316 438 443 285 283 283 283 283 283 283 283 283 283 283 283 283 283 283 
316 316 316 316 316 316 316 316 316 316 316 316 316 316 316 316 316 316 316 316 316 316 316 357 398 403 283 283 283 283 283 283 283 283 283 283 283 283 283 283 
316 316 316 316 316 316 316 316 316 316 316 316 316 316 316 316 316 316 316 316 316 316 316 316 438 403 283 283 283 283 283 283 283 283 283 283 283 283 283 283 
316 316 316 316 316 316 316 316 316 316 316 316 316 316 316 316 316 316 316 316 316 316 316 316 438 443 285 283 283 283 283 283 283 283 283 283 283 283 283 283 
316 316 316 316 316 316 316 316 316 316 316 316 316 316 316 316 316 316 316 316 316 316 316 316 357 398 403 283 283 283 283 283 283 283 283 283 283 283 283 283 
316 316 316 316 316 316 316 316 316 316 316 316 316 316 316 316 316 316 316 316 316 316 316 316 316 438 403 283 283 283 283 283 283 283 283 283 283 283 283 283 
316 316 316 316 316 316 316 316 316 316 316 316 316 316 316 316 316 316 316 316 316 316 316 316 316 438 443 285 283 283 283 283 283 283 283 283 283 283 283 283 
316 316 316 316 316 316 316 316 316 316 316 316 316 316 316 316 316 316 316 316 316 316 316 316 316 357 398 403 283 283 283 283 283 283 283 283 283 283 283 283 
316 316 316 316 316 316 316 316 316 316 316 316 316 316 316 316 316 316 316 316 316 316 316 316 316 316 438 403 283 283 283 283 283 283 283 283 283 283 283 283 
316 316 316 316 316 316 316 316 316 316 316 316 316 316 316 316 316 316 316 316 316 316 316 316 316 316 438 403 283 283 283 283 283 283 283 283 283 283 283 283 
316 316 316 316 316 316 316 316 316 316 316 316 316 316 316 316 316 316 316 316 316 316 316 316 316 316 438 403 283 283 283 283 283 283 283 283 283 283 283 283 
316 316 316 316 316 316 316 316 316 316 316 316 316 316 316 316 316 316 316 316 316 316 316 316 316 316 438 443 444 444 444 444 444 444 444 444 444 444 444 444 
316 316 316 316 316 316 316 316 316 316 316 316 316 316 316 316 316 316 316 316 316 316 316 316 316 316 357 398 0 0 0 0 815 695 695 695 695 695 695 695 
316 316 316 316 316 316 316 316 316 316 316 316 316 316 316 316 316 316 316 316 316 316 316 316 316 316 316 438 0 0 0 0 815 695 695 695 695 695 695 695 
316 316 316 316 316 316 316 316 316 316 316 316 316 316 316 316 316 316 316 316 316 316 316 316 316 317 477 478 0 0 0 0 815 695 695 695 695 695 695 695 
316 316 316 316 316 316 316 316 316 316 316 316 316 316 316 316 316 316 316 316 316 316 316 316 316 438 0 0 0 0 0 0 815 695 695 695 695 695 695 695 
316 316 316 316 316 316 316 316 316 316 316 316 316 316 316 316 316 316 316 316 316 316 316 317 477 478 0 0 0 0 0 0 815 695 695 695 695 695 695 695 
316 316 316 316 316 316 316 316 316 316 316 316 316 316 316 316 316 316 316 316 316 316 316 438 0 0 0 0 0 0 0 0 815 363 364 364 364 364 364 364 
316 316 316 316 316 316 316 316 316 316 316 316 316 316 316 316 316 316 316 316 316 316 316 438 0 0 0 0 0 0 0 0 815 403 283 283 283 283 283 283 
316 316 316 316 316 316 316 316 316 316 316 316 316 316 316 316 316 316 316 316 316 316 316 438 0 0 0 0 0 0 0 363 364 325 283 283 283 283 283 283 
316 316 316 316 316 316 316 316 316 316 316 316 316 316 316 316 316 316 316 316 316 316 316 438 0 0 0 0 0 0 0 403 283 283 283 283 283 283 283 283 
316 316 316 316 316 316 316 316 316 316 316 316 316 316 316 316 316 316 316 316 316 316 316 438 0 0 0 0 0 363 364 325 283 283 283 283 283 283 283 283 
316 316 316 316 316 316 316 316 316 316 316 316 316 316 316 316 316 316 316 316 316 316 316 438 0 0 0 0 0 403 283 283 283 283 283 283 283 283 283 283 
316 316 316 316 316 316 316 316 316 316 316 316 316 316 316 316 316 316 316 316 316 316 316 438 0 0 0 0 0 403 283 283 283 283 283 283 283 283 283 283 
1
0 0 10 0
