495 495 495 495 495 495 495 495 495 495 495 495 495 495 495 617 0 0 0 0 0 0 0 0 615 495 495 495 495 495 495 495 495 495 495 495 495 495 495 495 
495 495 495 495 495 495 495 495 495 495 495 495 495 495 495 617 0 0 0 0 0 0 0 0 615 495 495 495 495 495 495 495 495 495 495 495 495 495 495 495 
495 495 495 495 495 495 495 495 495 495 495 495 495 495 495 617 0 0 0 0 0 0 0 0 615 495 495 495 495 495 495 495 495 495 495 495 495 495 495 495 
495 495 495 495 495 495 495 495 495 495 495 495 495 495 495 617 696 696 696 696 696 696 696 696 615 495 495 495 495 495 495 495 495 495 495 495 495 495 495 495 
495 495 495 495 495 495 495 495 495 495 495 495 495 495 495 617 0 0 0 0 0 0 0 0 615 495 495 495 495 495 495 495 495 495 495 495 495 495 495 495 
495 495 495 495 495 495 495 495 495 495 495 495 495 495 495 617 0 0 0 0 0 0 0 0 615 495 495 495 495 495 495 495 495 495 495 495 495 495 495 495 
495 495 495 495 495 495 495 495 495 495 495 495 495 495 495 536 576 577 0 0 0 0 575 576 537 495 495 495 495 495 495 495 495 495 495 495 495 495 495 495 
495 495 495 495 495 495 495 495 495 495 495 495 495 495 495 495 495 617 696 696 696 696 615 495 495 495 495 495 495 495 495 495 495 495 495 495 495 495 495 495 
495 495 495 495 495 495 495 495 495 495 495 495 495 495 495 495 495 617 0 0 0 0 615 495 495 495 495 495 495 495 495 495 495 495 495 495 495 495 495 495 
495 495 495 495 495 495 495 495 495 495 495 495 495 495 495 495 495 617 0 0 0 0 615 495 495 495 495 495 495 495 495 495 495 495 495 495 495 495 495 495 
495 495 495 495 495 495 495 495 495 495 495 495 495 495 495 495 495 617 0 0 0 0 615 495 495 495 495 495 495 495 495 495 495 495 495 495 495 495 495 495 
656 656 656 656 656 656 656 656 656 656 656 656 656 656 656 656 656 657 0 0 0 0 615 495 495 495 495 495 495 495 495 495 495 495 495 495 495 495 495 495 
0 0 0 0 695 0 0 0 0 0 0 0 0 0 0 695 0 0 0 0 0 0 615 495 495 495 495 495 495 495 495 495 495 495 495 495 495 495 495 495 
0 0 0 0 695 0 0 0 0 0 0 0 0 0 0 695 0 0 0 0 0 0 615 495 495 495 495 495 495 495 495 495 495 495 495 495 495 495 495 495 
0 0 0 0 695 0 0 0 0 0 0 0 0 0 0 695 0 0 0 0 0 0 615 495 495 495 495 495 495 495 495 495 495 495 495 495 495 495 495 495 
0 0 0 0 695 0 0 0 0 0 0 0 0 0 0 695 0 0 0 0 0 0 615 495 495 495 495 495 495 495 495 495 495 495 495 495 495 495 495 495 
0 0 0 0 695 0 0 0 0 0 0 0 0 0 0 695 0 0 0 0 0 0 615 495 495 495 495 495 495 495 495 495 495 495 495 495 495 495 495 495 
0 0 0 0 695 0 0 0 0 0 0 0 0 0 0 695 0 0 0 0 0 0 615 495 495 495 495 495 495 495 495 495 495 495 495 495 495 495 495 495 
576 576 576 576 576 576 576 576 576 577 0 0 0 0 0 695 0 0 0 0 0 0 615 495 495 495 495 495 495 495 495 495 495 495 495 495 495 495 495 495 
495 495 495 495 495 495 495 495 495 617 0 0 0 0 0 695 0 0 0 0 0 0 615 495 495 495 495 495 495 495 495 495 495 495 495 495 495 495 495 495 
495 495 495 495 495 495 495 495 495 617 0 0 0 0 0 695 0 0 0 0 0 0 615 495 495 495 495 495 495 495 495 495 495 495 495 495 495 495 495 495 
495 495 495 495 495 495 495 495 495 536 576 576 576 576 576 576 576 577 0 0 0 0 615 495 495 495 495 495 495 495 495 495 495 495 495 495 495 495 495 495 
495 495 495 495 495 495 495 495 495 495 495 495 495 495 495 495 495 617 696 696 696 696 615 495 495 495 495 495 495 495 495 495 495 495 495 495 495 495 495 495 
495 495 495 495 495 495 495 495 495 495 495 495 495 495 495 496 656 657 0 0 0 0 655 656 497 495 495 495 495 495 495 495 495 495 495 495 495 495 495 495 
495 495 495 495 495 495 495 495 495 495 495 495 495 495 495 617 0 0 0 0 0 0 0 0 615 495 495 495 495 495 495 495 495 495 495 495 495 495 495 495 
495 495 495 495 495 495 495 495 495 495 495 495 495 495 495 617 0 0 0 0 0 0 0 0 615 495 495 495 495 495 495 495 495 495 495 495 495 495 495 495 
495 495 495 495 495 495 495 495 495 495 495 495 495 495 495 617 696 696 696 696 696 696 696 696 615 495 495 495 495 495 495 495 495 495 495 495 495 495 495 495 
495 495 495 495 495 495 495 495 495 495 495 495 495 495 495 617 0 0 0 0 0 0 0 0 615 495 495 495 495 495 495 495 495 495 495 495 495 495 495 495 
495 495 495 495 495 495 495 495 495 495 495 495 495 495 495 617 0 0 0 0 0 0 0 0 615 495 495 495 495 495 495 495 495 495 495 495 495 495 495 495 
495 495 495 495 495 495 495 495 495 495 495 495 495 495 495 617 0 0 0 0 0 0 0 0 615 495 495 495 495 495 495 495 495 495 495 495 495 495 495 495 
0
