292 292 292 292 292 292 292 292 292 292 292 292 292 292 292 292 292 292 292 292 292 292 292 292 292 292 292 292 292 292 292 292 292 292 292 292 292 292 292 292 
292 292 292 292 292 292 292 292 292 292 292 292 292 292 292 292 292 292 292 292 292 292 292 292 292 292 292 292 292 292 292 292 292 292 292 292 292 292 292 292 
292 292 292 292 292 292 292 292 292 292 292 293 453 453 453 294 292 292 292 292 292 292 292 292 293 453 453 453 294 292 292 292 292 292 292 292 292 292 292 292 
292 292 292 292 292 292 292 292 292 292 292 414 9 9 9 412 292 292 292 292 292 292 292 292 414 9 9 9 412 292 292 292 292 292 292 292 292 292 292 292 
292 292 292 292 292 292 292 292 292 292 292 414 0 0 0 412 292 292 292 292 292 292 292 292 414 0 0 0 412 292 292 292 292 292 292 292 292 292 292 292 
292 292 292 292 292 292 292 292 292 292 292 414 0 0 0 412 292 292 292 292 292 292 292 292 414 0 0 0 412 292 292 292 292 292 292 292 292 292 292 292 
292 292 292 292 292 292 292 292 292 292 292 414 0 0 0 412 292 292 292 292 292 292 292 292 414 0 0 0 412 292 292 292 292 292 292 292 292 292 292 292 
292 292 292 292 292 292 292 292 292 292 292 414 782 782 782 412 292 292 292 292 292 292 292 292 414 782 782 782 412 292 292 292 292 292 292 292 292 292 292 292 
453 453 453 453 453 453 453 453 453 453 453 454 701 701 701 452 453 453 453 453 453 453 453 453 454 701 701 701 452 453 453 453 453 453 453 453 453 453 453 453 
701 701 701 701 701 701 701 701 701 701 701 701 701 701 701 701 701 701 701 701 701 701 701 701 701 701 701 701 701 701 701 701 701 701 701 701 701 701 701 701 
701 701 701 701 701 701 701 701 701 701 701 701 701 701 701 701 701 701 701 701 701 701 701 701 701 701 701 701 701 701 701 701 701 701 701 701 701 701 701 701 
701 701 701 701 701 701 701 701 701 701 701 701 701 701 701 701 701 701 701 701 701 701 701 701 701 701 701 701 701 701 701 701 701 701 701 701 701 701 701 701 
701 701 701 701 701 701 701 701 701 701 701 701 701 701 701 701 701 701 701 701 701 701 701 701 701 701 701 701 701 701 701 701 701 701 701 701 701 701 701 701 
701 701 701 701 701 701 701 701 701 701 701 701 701 701 701 701 701 701 701 701 701 701 701 701 701 701 701 701 701 701 701 701 701 701 701 701 701 701 701 701 
373 373 373 373 373 373 374 701 701 701 372 373 373 373 373 373 373 374 701 701 701 701 372 373 373 373 373 373 373 374 701 701 701 372 373 373 373 373 373 373 
292 292 292 292 292 292 414 701 701 701 412 292 292 292 292 292 292 414 701 701 701 701 412 292 292 292 292 292 292 414 701 701 701 412 292 292 292 292 292 292 
453 453 453 453 453 294 414 862 862 862 412 292 292 292 292 292 292 414 862 862 862 862 412 292 292 292 292 292 292 414 862 862 862 412 293 453 453 453 453 453 
0 0 0 0 0 412 414 0 0 0 412 292 292 292 292 292 292 414 0 0 0 0 412 292 292 292 292 292 292 414 0 0 0 412 414 0 0 0 0 0 
0 0 0 0 0 412 414 0 0 0 412 292 292 292 292 292 292 414 0 0 0 0 412 292 292 292 292 292 292 414 0 0 0 412 414 0 0 0 0 0 
0 0 0 0 0 412 414 8 8 8 412 292 292 292 292 292 292 414 0 0 0 0 412 292 292 292 292 292 292 414 8 8 8 412 414 0 0 0 0 0 
0 0 0 0 0 412 333 373 373 373 334 292 292 292 292 292 292 414 0 0 0 0 412 292 292 292 292 292 292 333 373 373 373 334 414 0 0 0 0 0 
0 0 0 0 0 452 453 453 453 453 453 453 453 453 453 294 292 414 8 8 8 8 412 292 293 453 453 453 453 453 453 453 453 453 454 0 0 0 0 0 
0 0 0 0 0 0 0 0 0 0 0 0 0 0 0 412 292 333 373 373 373 373 334 292 414 0 0 0 0 0 0 0 0 0 0 0 0 0 0 0 
0 0 0 0 0 0 0 0 0 0 0 0 0 0 0 452 453 453 453 453 453 453 453 453 454 0 0 0 0 0 0 0 0 0 0 0 0 0 0 0 
0 0 0 0 0 0 0 0 0 0 0 0 0 0 0 0 0 0 0 0 0 0 0 0 0 0 0 0 0 0 0 0 0 0 0 0 0 0 0 0 
0 0 0 0 0 0 0 0 0 0 0 0 0 0 0 0 0 0 0 0 0 0 0 0 0 0 0 0 0 0 0 0 0 0 0 0 0 0 0 0 
0 0 0 0 0 0 0 0 0 0 0 0 0 0 0 0 0 0 0 0 0 0 0 0 0 0 0 0 0 0 0 0 0 0 0 0 0 0 0 0 
0 0 0 0 0 0 0 0 0 0 0 0 0 0 0 0 0 0 0 0 0 0 0 0 0 0 0 0 0 0 0 0 0 0 0 0 0 0 0 0 
0 0 0 0 0 0 0 0 0 0 0 0 0 0 0 0 0 0 0 0 0 0 0 0 0 0 0 0 0 0 0 0 0 0 0 0 0 0 0 0 
0 0 0 0 0 0 0 0 0 0 0 0 0 0 0 0 0 0 0 0 0 0 0 0 0 0 0 0 0 0 0 0 0 0 0 0 0 0 0 0 
1
0 0 10 0
