104 104 104 104 104 104 104 104 104 104 104 104 104 104 104 104 104 104 104 104 104 104 104 104 104 104 104 104 104 104 104 104 104 104 104 104 104 104 104 104 
104 104 104 104 104 104 104 104 104 104 104 104 104 104 104 104 104 104 104 104 104 104 104 104 104 104 104 104 104 104 104 104 104 104 104 104 104 104 104 104 
104 104 104 104 104 104 104 104 104 104 104 104 104 104 104 104 104 104 104 104 104 104 104 104 104 104 104 104 104 104 104 104 104 104 104 104 104 104 104 104 
104 104 104 104 104 104 104 104 104 104 104 104 104 104 104 104 104 104 104 104 104 104 104 104 104 104 104 104 104 104 104 104 104 104 104 104 104 104 104 104 
104 104 104 104 104 104 104 104 104 104 104 104 104 104 104 104 104 104 104 104 104 104 104 104 104 104 104 104 104 104 104 104 104 104 104 104 104 104 104 104 
104 104 104 104 104 104 104 104 104 104 104 104 104 104 104 104 104 104 104 104 104 104 104 104 104 104 104 104 104 104 104 104 104 104 104 104 104 104 104 104 
104 104 104 104 104 104 104 104 104 104 104 104 104 104 104 104 104 104 104 104 104 104 104 104 104 104 104 104 104 104 104 104 104 104 104 104 104 104 104 104 
104 104 104 104 104 104 104 104 104 104 104 104 104 104 104 104 104 104 104 104 104 104 104 104 104 104 104 104 104 104 104 104 104 104 104 104 104 104 104 104 
265 265 265 265 265 265 265 265 265 265 265 265 265 265 265 265 265 265 265 265 265 265 265 265 265 265 265 265 265 265 265 265 265 265 265 265 265 265 265 265 
704 704 704 704 704 704 704 704 704 704 704 704 704 704 704 704 704 704 704 704 704 704 704 704 704 704 704 704 704 704 704 704 704 704 704 704 704 704 704 704 
704 704 704 704 704 704 704 704 704 704 704 704 704 704 704 704 704 704 704 704 704 704 704 705 865 865 706 704 705 865 865 706 704 705 865 865 706 704 704 704 
704 704 704 704 704 704 704 704 704 704 704 704 704 704 704 704 704 704 704 704 704 704 704 826 0 0 824 704 826 0 0 824 704 826 0 0 824 704 704 704 
704 704 704 704 704 704 704 704 704 704 704 704 704 704 704 704 704 704 704 704 704 704 704 826 0 0 824 704 826 0 0 824 704 826 0 0 824 704 704 704 
704 704 704 704 704 704 704 704 704 704 704 704 704 704 704 704 704 704 704 704 704 704 704 826 0 0 824 704 826 0 0 824 704 826 0 0 824 704 704 704 
185 185 185 185 185 185 185 185 185 185 185 185 185 185 185 185 185 185 186 704 704 704 704 826 0 0 824 704 826 0 0 824 704 826 0 0 824 704 704 704 
104 104 104 104 104 104 104 104 104 104 104 104 104 104 104 104 104 104 226 704 704 704 704 826 0 0 824 704 826 0 0 824 704 826 0 0 824 704 704 704 
265 265 265 265 265 265 265 265 265 265 265 265 265 265 265 106 104 104 226 704 704 704 704 826 0 0 824 704 826 0 0 824 704 826 0 0 824 704 704 704 
0 0 0 0 0 0 0 0 0 0 0 0 0 0 0 224 104 104 226 704 704 704 704 826 0 0 824 704 826 0 0 824 704 826 0 0 824 704 704 704 
0 0 0 0 0 0 0 0 0 0 0 0 0 0 0 224 104 104 226 704 704 704 704 826 0 0 824 704 826 0 0 824 704 826 0 0 824 704 704 704 
0 0 0 0 0 0 0 0 0 0 0 0 0 0 0 224 104 104 226 704 704 704 704 745 785 785 746 704 745 785 785 746 704 745 785 785 746 704 704 704 
0 0 0 0 0 0 0 0 0 0 0 0 0 0 0 224 104 104 226 704 704 704 704 704 704 704 704 704 704 704 704 704 704 704 704 704 704 704 704 704 
0 0 0 0 0 0 0 0 0 0 0 0 0 0 0 224 104 104 145 185 185 185 185 185 185 185 185 185 185 185 185 185 185 185 185 185 185 185 185 185 
0 0 0 0 0 0 0 0 0 0 0 0 0 0 0 224 104 104 104 104 104 104 104 104 104 104 104 104 104 104 104 104 104 104 104 104 104 104 104 104 
0 0 0 0 0 0 0 0 0 0 0 0 0 0 0 264 265 265 265 265 265 265 265 265 265 265 265 265 265 265 265 265 265 265 265 265 265 265 265 265 
0 0 0 0 0 0 0 0 0 0 0 0 0 0 0 0 0 0 0 0 0 0 0 0 0 0 0 0 0 0 0 0 0 0 0 0 0 0 0 0 
0 0 0 0 0 0 0 0 0 0 0 0 0 0 0 0 0 0 0 0 0 0 0 0 0 0 0 0 0 0 0 0 0 0 0 0 0 0 0 0 
0 0 0 0 0 0 0 0 0 0 0 0 0 0 0 0 0 0 0 0 0 0 0 0 0 0 0 0 0 0 0 0 0 0 0 0 0 0 0 0 
0 0 0 0 0 0 0 0 0 0 0 0 0 0 0 0 0 0 0 0 0 0 0 0 0 0 0 0 0 0 0 0 0 0 0 0 0 0 0 0 
0 0 0 0 0 0 0 0 0 0 0 0 0 0 0 0 0 0 0 0 0 0 0 0 0 0 0 0 0 0 0 0 0 0 0 0 0 0 0 0 
0 0 0 0 0 0 0 0 0 0 0 0 0 0 0 0 0 0 0 0 0 0 0 0 0 0 0 0 0 0 0 0 0 0 0 0 0 0 0 0 
1
0 0 10 0
