89 89 89 89 89 89 89 89 89 89 89 89 89 89 89 89 89 89 89 89 89 89 89 89 89 89 89 211 695 695 695 695 695 695 209 89 89 89 89 89 
89 89 89 89 89 89 89 89 89 89 89 89 89 89 89 89 89 89 89 89 89 89 89 89 89 89 89 211 695 695 695 695 695 695 209 89 89 89 89 89 
89 89 89 89 89 89 89 89 89 89 89 89 89 89 89 89 89 89 89 89 89 89 89 89 89 89 89 211 695 695 695 695 695 695 209 89 89 89 89 89 
89 89 89 89 89 89 89 89 89 89 89 89 89 89 89 89 89 89 89 89 89 89 89 89 89 89 89 211 695 695 695 695 695 695 209 89 89 89 89 89 
89 89 89 89 89 89 89 89 89 89 89 89 89 89 89 89 89 89 89 89 89 89 89 89 89 89 89 211 695 695 695 695 695 695 209 89 89 89 89 89 
89 89 89 89 89 89 89 89 89 89 89 89 89 89 89 89 89 89 89 89 89 89 89 89 89 89 89 211 695 695 695 695 695 695 209 89 89 89 89 89 
89 89 89 89 89 89 89 89 89 89 89 89 89 89 89 89 89 89 89 89 89 89 89 89 89 89 89 211 695 695 695 695 695 695 209 89 89 89 89 89 
89 89 89 89 89 89 89 89 89 89 89 89 89 89 89 89 89 89 89 89 89 89 89 89 89 89 89 211 695 695 695 695 695 695 209 89 89 89 89 89 
89 89 89 89 89 89 89 89 89 89 89 89 89 89 89 89 89 89 89 89 89 89 89 89 89 89 89 211 695 695 695 695 695 695 209 89 89 89 89 89 
89 89 89 89 89 89 89 89 89 89 89 89 89 89 89 89 89 89 89 89 89 89 89 89 89 89 89 211 695 695 695 695 695 695 209 89 89 89 89 89 
89 89 89 89 89 89 89 89 89 89 89 89 89 89 89 89 89 89 89 89 89 89 89 89 89 89 89 211 695 695 695 695 695 695 209 89 89 89 89 89 
89 89 89 89 89 89 89 89 89 89 89 89 89 89 89 89 89 89 89 89 89 89 89 89 89 89 89 211 695 695 695 695 695 695 209 89 89 89 89 89 
89 89 89 89 89 89 89 89 89 89 89 89 89 89 89 89 89 89 89 89 89 89 89 89 89 89 89 211 695 695 695 695 695 695 209 89 89 89 89 89 
89 89 89 89 89 89 89 89 89 89 89 89 89 89 89 89 89 89 89 89 89 89 89 89 89 89 89 211 695 695 695 695 695 695 209 89 89 89 89 89 
250 250 250 250 250 250 250 250 250 250 250 250 250 250 250 250 250 250 250 250 250 250 250 250 250 250 250 251 695 695 695 695 695 695 209 89 89 89 89 89 
0 0 0 0 0 0 0 0 0 815 695 695 695 695 695 695 695 695 695 695 695 695 695 695 695 695 695 695 695 695 695 695 695 695 209 89 89 89 89 89 
0 0 0 0 0 0 0 0 0 815 695 695 695 695 695 695 695 695 695 695 695 695 695 695 695 695 695 695 695 695 695 695 695 695 209 89 89 89 89 89 
0 0 0 0 0 0 0 0 0 815 695 695 695 695 695 695 695 695 695 695 695 695 695 695 695 695 695 695 695 695 695 695 695 695 209 89 89 89 89 89 
0 0 0 0 0 0 0 0 0 815 695 695 695 695 695 695 695 695 695 695 695 695 695 695 695 695 695 695 695 695 695 695 695 695 209 89 89 89 89 89 
0 0 0 0 0 0 0 0 0 815 695 695 695 695 695 695 695 695 695 695 695 695 695 695 695 695 695 695 695 695 695 695 695 695 209 89 89 89 89 89 
0 0 0 0 0 0 0 0 0 815 695 695 695 695 695 695 695 695 695 695 695 695 695 695 695 695 695 695 695 695 695 695 695 695 209 89 89 89 89 89 
0 0 0 0 0 0 0 0 0 815 695 695 695 695 695 695 695 695 695 695 695 695 695 695 695 695 695 695 695 695 695 695 695 695 209 89 89 89 89 89 
0 0 0 0 0 0 0 0 0 815 695 695 695 695 695 695 695 695 695 695 695 695 695 695 695 695 695 695 695 695 695 695 695 695 209 89 89 89 89 89 
0 0 0 0 0 0 0 0 0 815 695 695 695 695 695 695 695 695 695 695 695 695 695 695 695 695 695 695 695 695 695 695 695 695 209 89 89 89 89 89 
0 0 0 0 0 0 0 0 0 815 695 695 695 695 695 695 695 695 695 695 695 695 695 695 695 695 695 695 695 695 695 695 695 695 209 89 89 89 89 89 
0 0 0 0 0 0 0 0 0 815 695 695 695 695 695 695 695 695 695 695 169 170 170 170 170 170 170 170 170 170 170 170 170 170 131 89 89 89 89 89 
0 0 0 0 0 0 0 0 0 855 856 856 856 856 856 856 856 856 856 856 209 89 89 89 89 89 89 89 89 89 89 89 89 89 89 89 89 89 89 89 
0 0 0 0 0 0 0 0 0 0 0 0 0 0 0 0 0 0 0 0 209 89 89 89 89 89 89 89 89 89 89 89 89 89 89 89 89 89 89 89 
0 0 0 0 0 0 0 0 0 0 0 0 0 0 0 0 0 0 0 0 209 89 89 89 89 89 89 89 89 89 89 89 89 89 89 89 89 89 89 89 
0 0 0 0 0 0 0 0 0 0 0 0 0 0 0 0 0 0 0 0 209 89 89 89 89 89 89 89 89 89 89 89 89 89 89 89 89 89 89 89 
1
0 0 10 0
