495 495 495 495 495 495 495 495 495 495 495 495 495 495 495 495 495 495 495 495 495 495 495 495 495 495 495 495 495 495 495 495 495 495 495 495 495 495 495 495 
495 495 495 495 495 495 495 495 495 495 495 495 495 495 495 495 495 495 495 495 495 495 495 495 495 495 495 495 495 495 495 495 495 495 495 495 495 495 495 495 
495 495 495 496 656 656 656 656 656 656 656 656 656 656 656 656 656 656 497 495 495 495 495 495 495 495 495 495 495 495 495 495 495 495 495 495 495 495 495 495 
495 495 496 657 0 0 0 0 0 0 0 0 0 0 0 0 0 0 655 497 495 495 495 495 495 495 495 495 495 495 495 495 495 495 495 495 495 495 495 495 
495 495 617 0 0 0 0 0 0 0 0 0 0 0 0 0 0 0 0 655 656 656 656 656 656 656 656 656 656 656 656 656 656 656 497 495 495 495 495 495 
495 495 617 0 0 0 0 0 0 0 0 0 0 0 0 0 0 0 0 0 0 0 0 0 0 0 0 0 0 0 0 0 0 0 615 495 495 495 495 495 
495 495 617 0 0 0 0 0 0 0 0 0 0 0 0 0 0 0 0 0 0 0 0 0 0 0 0 0 0 0 0 0 0 0 615 495 495 495 495 495 
495 495 617 0 0 0 0 0 0 0 0 0 0 0 0 0 0 0 0 0 0 0 0 0 0 0 0 0 0 0 0 0 0 0 615 495 495 495 495 495 
495 495 617 0 0 0 0 0 0 0 0 0 0 0 0 0 0 0 0 0 0 0 0 0 0 0 0 0 0 0 0 0 0 0 615 495 495 495 495 495 
495 495 617 0 0 0 0 0 0 0 0 0 0 0 0 0 0 0 0 0 0 0 0 0 0 0 0 0 0 0 0 0 0 0 615 495 495 495 495 495 
495 495 617 0 0 0 0 0 0 0 0 0 0 0 0 0 0 0 0 0 0 0 0 0 0 0 0 0 0 0 0 0 0 0 615 495 495 495 495 495 
495 495 617 0 0 0 0 0 0 0 0 0 0 0 0 0 0 0 0 0 0 0 760 761 761 761 761 761 761 761 761 761 761 761 615 495 495 495 495 495 
495 495 617 0 0 0 0 0 0 0 0 0 0 0 0 0 0 0 0 0 0 0 800 680 680 680 680 680 680 680 680 680 680 680 615 495 495 495 495 495 
495 495 617 0 0 0 0 0 0 0 0 0 0 0 0 0 0 0 0 0 0 0 800 680 680 680 680 680 680 680 680 680 680 680 615 495 495 495 495 495 
495 495 617 0 0 0 0 0 0 0 0 0 0 0 0 0 0 0 0 0 0 0 800 680 680 680 680 680 680 680 680 680 680 680 615 495 495 495 495 495 
495 495 617 0 0 0 0 0 0 0 0 0 0 0 0 0 0 0 0 0 0 0 800 680 680 680 680 680 680 680 680 680 680 680 615 495 495 495 495 495 
495 495 617 0 0 0 0 0 0 0 0 0 0 0 0 0 0 0 0 0 0 0 800 680 680 680 680 680 680 680 680 680 680 680 615 495 495 495 495 495 
495 495 617 0 0 0 0 0 0 0 0 0 0 0 0 0 0 0 0 575 576 576 576 576 576 576 576 577 680 680 680 680 680 680 615 495 495 495 495 495 
495 495 536 576 577 0 0 0 0 0 0 0 0 0 0 0 0 0 575 537 495 495 495 495 495 495 495 617 680 680 680 680 680 680 615 495 495 495 495 495 
495 495 495 495 536 576 576 576 576 576 576 576 576 576 576 576 576 576 537 495 495 495 495 495 495 495 495 617 680 680 680 680 680 680 615 495 495 495 495 495 
495 495 495 495 495 495 495 495 495 495 495 495 495 495 495 495 495 495 495 495 495 495 495 495 495 495 495 617 680 680 680 680 680 680 615 495 495 495 495 495 
495 495 495 495 495 495 495 495 495 495 495 495 495 495 495 495 495 495 495 495 495 495 495 495 495 495 495 617 680 680 680 680 680 680 615 495 495 495 495 495 
495 495 495 495 495 495 495 495 495 495 495 495 495 495 495 495 495 495 495 495 495 495 495 495 495 495 495 617 680 680 680 680 680 680 615 495 495 495 495 495 
495 495 495 495 495 495 495 495 495 495 495 495 495 495 495 495 495 495 495 495 495 495 495 495 495 495 495 617 680 680 680 680 680 680 615 495 495 495 495 495 
495 495 495 495 495 495 495 495 495 495 495 495 495 495 495 495 495 495 495 495 495 495 495 495 495 495 495 617 680 680 680 680 680 680 615 495 495 495 495 495 
495 495 495 495 495 495 495 495 495 495 495 495 495 495 495 495 495 495 495 495 495 495 495 495 495 495 495 617 680 680 680 680 680 680 615 495 495 495 495 495 
495 495 495 495 495 495 495 495 495 495 495 495 495 495 495 495 495 495 495 495 495 495 495 495 495 495 495 617 680 680 680 680 680 680 615 495 495 495 495 495 
495 495 495 495 495 495 495 495 495 495 495 495 495 495 495 495 495 495 495 495 495 495 495 495 495 495 495 617 680 680 680 680 680 680 615 495 495 495 495 495 
495 495 495 495 495 495 495 495 495 495 495 495 495 495 495 495 495 495 495 495 495 495 495 495 495 495 495 617 680 680 680 680 680 680 615 495 495 495 495 495 
495 495 495 495 495 495 495 495 495 495 495 495 495 495 495 495 495 495 495 495 495 495 495 495 495 495 495 617 680 680 680 680 680 680 615 495 495 495 495 495 
3
5 5 8
24 15 10 1
0 0 10 0
