0 0 0 0 0 0 0 0 0 0 0 0 0 0 0 0 0 0 0 600 480 480 480 480 480 480 480 480 480 480 480 480 480 480 480 480 480 480 480 480 
0 0 0 0 0 0 0 0 0 0 0 0 0 0 0 0 0 0 0 600 480 480 480 480 480 480 480 480 480 480 480 480 480 480 480 480 480 480 480 480 
0 0 0 0 0 0 0 0 0 0 0 0 0 0 0 0 0 0 0 600 480 480 480 480 480 480 480 480 480 480 480 480 480 480 480 480 480 480 480 480 
0 0 0 0 0 0 0 0 0 0 0 0 0 0 0 0 0 0 0 600 480 480 480 480 480 480 480 480 480 480 480 480 480 480 480 480 480 480 480 480 
0 0 0 0 0 0 0 0 0 0 0 0 0 0 0 0 0 0 0 600 480 480 480 480 480 480 480 480 480 480 480 480 480 480 480 480 480 480 480 480 
0 0 0 0 0 0 0 0 0 0 0 0 0 0 0 0 0 0 0 600 480 480 480 480 480 480 480 480 480 480 480 480 480 480 480 480 480 480 480 480 
0 0 0 0 0 0 0 0 0 0 0 0 0 0 0 0 0 0 0 600 480 480 480 480 480 480 480 480 480 480 480 480 480 480 480 480 480 480 480 480 
0 0 0 0 0 0 0 0 0 0 0 0 0 0 0 0 0 0 0 600 480 480 480 480 480 480 480 480 480 480 480 480 480 480 480 480 480 480 480 480 
0 0 0 0 0 0 0 0 0 0 0 0 0 0 0 0 0 0 0 600 480 480 480 480 480 480 480 480 480 480 480 480 480 480 480 480 480 480 480 480 
0 0 0 0 0 0 0 0 0 0 0 0 0 0 0 0 0 0 0 600 480 480 480 480 480 480 480 480 480 480 480 480 480 480 480 480 480 480 480 480 
0 0 0 0 0 0 0 0 0 0 0 0 0 0 0 0 0 0 0 640 482 480 480 480 480 480 480 480 480 480 480 480 480 480 480 480 480 480 480 480 
0 0 0 0 0 0 0 0 0 0 0 0 0 0 0 0 0 0 0 0 600 480 480 480 480 480 480 480 480 480 480 480 480 480 480 480 480 480 480 480 
0 0 0 0 0 0 0 0 0 0 0 0 0 0 0 0 0 0 0 0 640 482 480 480 480 480 480 480 480 480 480 480 480 480 480 480 480 480 480 480 
0 0 0 0 0 0 0 0 0 0 0 0 0 0 0 0 0 0 0 0 0 600 480 480 480 480 480 480 480 480 480 480 480 480 480 480 480 480 480 480 
0 0 0 0 0 0 0 0 0 0 0 0 0 0 0 0 0 0 0 0 0 600 480 480 480 480 480 480 480 480 480 480 480 480 480 480 480 480 480 480 
561 561 561 561 561 562 0 0 0 0 0 0 0 0 0 0 0 0 0 0 0 600 480 480 480 480 480 480 480 480 480 480 480 480 480 480 480 480 480 480 
480 480 480 480 480 521 561 561 562 0 0 0 0 0 0 0 0 0 0 0 0 600 480 480 480 480 480 480 480 480 480 480 480 480 480 480 480 480 480 480 
480 480 480 480 480 480 480 480 521 561 561 561 561 562 0 0 0 0 0 0 0 600 480 480 480 480 480 480 480 480 480 480 480 480 480 480 480 480 480 480 
480 480 480 480 480 480 480 480 480 480 480 480 480 521 561 561 561 561 561 561 561 522 480 480 480 480 480 480 480 480 480 480 480 480 480 480 480 480 480 480 
480 480 480 480 480 480 480 480 480 480 480 480 480 480 480 480 480 480 480 480 480 480 480 480 480 480 480 480 480 480 480 480 480 480 480 480 480 480 480 480 
480 480 480 480 480 480 480 480 480 480 480 480 480 480 480 480 480 480 480 480 480 480 480 480 480 480 480 480 480 480 480 480 480 480 480 480 480 480 480 480 
480 480 480 480 480 480 480 480 480 480 480 480 480 480 480 480 480 480 480 480 480 480 480 480 480 480 480 480 480 480 480 480 480 480 480 480 480 480 480 480 
480 480 480 480 480 480 480 480 480 480 480 480 480 480 480 480 480 480 480 480 480 480 480 480 480 480 480 480 480 480 480 480 480 480 480 480 480 480 480 480 
480 480 480 480 480 480 480 480 480 480 480 480 480 480 480 480 480 480 480 480 480 480 480 480 480 480 480 480 480 480 480 480 480 480 480 480 480 480 480 480 
480 480 480 480 480 480 480 480 480 480 480 480 480 480 480 480 480 480 480 480 480 480 480 480 480 480 480 480 480 480 480 480 480 480 480 480 480 480 480 480 
480 480 480 480 480 480 480 480 480 480 480 480 480 480 480 480 480 480 480 480 480 480 480 480 480 480 480 480 480 480 480 480 480 480 480 480 480 480 480 480 
480 480 480 480 480 480 480 480 480 480 480 480 480 480 480 480 480 480 480 480 480 480 480 480 480 480 480 480 480 480 480 480 480 480 480 480 480 480 480 480 
480 480 480 480 480 480 480 480 480 480 480 480 480 480 480 480 480 480 480 480 480 480 480 480 480 480 480 480 480 480 480 480 480 480 480 480 480 480 480 480 
480 480 480 480 480 480 480 480 480 480 480 480 480 480 480 480 480 480 480 480 480 480 480 480 480 480 480 480 480 480 480 480 480 480 480 480 480 480 480 480 
480 480 480 480 480 480 480 480 480 480 480 480 480 480 480 480 480 480 480 480 480 480 480 480 480 480 480 480 480 480 480 480 480 480 480 480 480 480 480 480 
0
