313 313 313 313 313 313 313 435 0 0 0 0 433 313 313 313 313 313 313 313 313 313 313 313 313 313 313 313 313 313 313 313 313 313 313 313 313 313 313 313 
313 313 313 313 313 313 313 435 0 0 0 0 433 313 313 313 313 313 313 313 313 313 313 313 313 313 313 314 474 474 474 474 474 474 474 474 474 474 474 474 
313 313 313 313 313 313 313 435 770 770 771 0 433 313 313 313 313 313 313 313 313 313 313 313 313 313 313 435 9 9 9 9 9 9 9 9 9 9 9 9 
313 313 313 313 313 313 313 435 689 689 811 0 433 313 313 313 313 313 313 313 313 313 313 313 313 313 313 435 0 0 0 0 0 0 0 0 0 0 0 0 
313 313 313 314 474 474 474 475 689 689 811 0 473 474 474 474 474 474 474 474 474 474 474 474 474 474 474 475 0 0 0 0 0 0 0 0 0 0 0 0 
313 313 313 435 0 0 0 0 689 689 811 0 0 0 0 0 0 0 0 0 0 0 0 0 0 0 0 0 0 0 0 0 0 0 0 0 0 0 0 0 
313 313 313 435 689 689 689 689 689 689 811 0 0 0 0 0 0 0 0 0 0 0 0 0 0 0 0 0 0 0 0 0 0 0 0 0 0 0 0 0 
313 313 313 435 689 689 689 689 689 689 811 0 0 0 0 0 0 0 0 0 0 0 0 0 0 0 0 0 0 0 0 0 0 0 0 0 0 0 0 0 
313 313 313 435 689 689 689 689 689 689 811 0 0 0 0 0 0 0 0 0 0 0 0 0 0 0 0 0 0 0 0 0 0 0 0 0 0 0 0 0 
313 313 313 435 689 689 689 689 689 689 811 0 0 0 0 0 0 0 0 0 0 0 0 0 0 0 0 0 0 0 0 0 0 0 0 0 0 0 0 0 
313 313 313 435 689 689 689 689 689 689 811 0 0 0 0 0 0 0 0 0 0 0 0 0 0 0 0 0 0 0 0 0 0 0 0 0 0 0 0 0 
313 313 313 435 689 689 689 689 689 689 811 0 0 0 0 0 0 0 0 0 0 0 0 0 0 0 0 0 0 0 0 0 0 0 0 0 0 0 0 0 
313 313 313 435 689 689 689 689 393 394 394 394 394 394 394 395 0 0 0 0 0 0 0 0 0 0 0 0 0 0 0 0 0 0 0 0 0 0 0 0 
313 313 313 435 689 689 689 689 473 474 474 474 474 474 474 475 0 0 0 0 0 0 0 0 0 0 0 0 0 0 0 0 0 0 0 0 0 0 0 0 
313 313 313 435 689 689 689 689 0 0 0 0 0 0 0 0 0 0 0 0 0 0 0 0 0 0 0 0 0 0 0 0 0 0 0 0 0 0 0 0 
313 313 313 435 689 689 689 689 689 689 811 0 0 0 0 0 0 0 0 0 0 0 0 0 0 0 0 0 0 0 0 0 0 0 0 0 0 0 0 0 
313 313 313 435 689 689 689 689 689 689 811 0 0 0 0 0 0 0 0 0 0 0 0 0 0 0 0 0 0 0 0 0 0 0 0 0 0 0 0 0 
313 313 313 435 689 689 689 689 689 689 811 0 0 0 0 0 0 0 0 0 0 0 0 0 0 0 0 0 0 0 0 0 0 0 0 0 0 0 0 0 
313 313 313 435 850 850 850 850 850 850 851 0 0 0 0 0 0 0 0 0 0 0 0 0 0 0 0 0 0 0 0 0 0 0 0 0 0 0 0 0 
313 313 313 435 0 0 0 0 0 0 0 0 0 0 0 0 0 0 0 0 0 0 0 0 0 0 0 0 0 0 0 0 0 0 0 0 0 0 0 0 
313 313 313 435 0 0 0 0 0 0 0 0 0 0 0 0 0 0 0 0 0 0 0 0 0 0 0 0 0 0 0 0 0 0 0 0 0 0 0 0 
313 313 313 435 0 0 0 0 0 0 0 0 0 0 0 0 0 0 0 0 0 0 0 0 0 0 0 0 0 0 0 0 0 0 0 0 0 0 0 0 
313 313 313 435 0 0 0 0 0 0 0 0 0 0 0 0 0 0 0 0 0 0 0 0 0 0 0 0 0 0 0 0 0 0 0 0 0 0 0 0 
313 313 313 354 394 394 394 394 394 395 0 0 0 0 0 0 0 0 0 0 0 0 0 0 0 0 0 0 0 0 0 0 0 0 0 0 0 0 0 0 
313 313 313 313 313 313 313 313 313 435 0 0 0 0 0 0 0 0 0 0 0 0 0 0 0 0 0 0 0 0 0 0 0 0 0 0 0 0 0 0 
313 313 313 313 313 313 313 313 313 435 8 8 8 8 8 8 8 8 8 8 8 8 8 8 8 8 8 8 8 8 8 8 8 8 8 8 8 8 8 8 
313 313 313 313 313 313 313 313 313 354 394 394 394 394 394 394 394 394 394 394 394 394 394 394 394 394 394 394 394 394 394 394 394 394 394 394 394 394 394 394 
313 313 313 313 313 313 313 313 313 313 313 313 313 313 313 313 313 313 313 313 313 313 313 313 313 313 313 313 313 313 313 313 313 313 313 313 313 313 313 313 
313 313 313 313 313 313 313 313 313 313 313 313 313 313 313 313 313 313 313 313 313 313 313 313 313 313 313 313 313 313 313 313 313 313 313 313 313 313 313 313 
15
32 14 2 8 4 0 0 320 240
24 14 2 8 4 0 0 320 240
16 14 2 8 4 0 0 320 240
8 14 2 8 4 0 0 320 240
16 13 2 7 4 0 0 320 240
24 13 2 7 4 0 0 320 240
32 13 2 7 4 0 0 320 240
13 16 1 0 5 104 120 288 200
9 10 10 1
12 5 2 8 4 0 0 320 240
20 5 2 8 4 0 0 320 240
4 5 2 6 4 0 0 320 240
20 21 1 1 5 104 120 288 200
27 16 1 0 5 104 120 288 200
34 21 1 1 5 104 120 288 200
