95 95 95 95 95 95 95 95 95 95 95 95 95 95 95 95 95 95 95 95 95 95 95 95 95 95 95 95 95 95 95 95 95 95 95 95 95 95 95 95 
95 95 95 95 95 95 95 95 95 95 95 95 95 95 95 95 95 95 95 95 95 95 95 95 95 95 95 95 95 95 95 95 95 95 95 95 95 95 95 95 
95 95 95 95 95 95 95 95 95 95 95 95 95 95 95 95 95 95 95 95 95 95 95 95 95 95 95 95 95 95 95 95 95 95 95 95 95 95 95 95 
95 95 95 95 95 95 95 95 95 95 95 95 95 95 95 95 95 95 95 95 95 95 95 95 95 95 95 95 95 95 95 95 95 95 95 95 95 95 95 95 
95 95 95 95 95 95 95 95 95 95 95 95 95 95 95 95 95 95 95 95 95 95 95 95 95 95 95 95 95 95 95 95 95 95 95 95 95 95 95 95 
95 95 95 95 95 95 95 95 95 95 95 95 95 95 95 95 95 95 95 95 95 95 95 95 95 95 95 95 95 95 95 95 95 96 256 256 256 256 256 256 
95 95 95 95 95 95 95 95 95 95 95 95 95 95 95 95 95 95 95 95 95 95 95 95 95 95 95 95 95 95 95 95 95 217 0 0 0 0 0 0 
95 95 95 95 95 95 95 95 95 95 95 95 95 95 95 95 95 95 95 95 95 95 95 95 95 95 95 95 95 95 95 95 95 217 0 0 0 0 0 0 
95 95 95 95 95 95 95 95 95 95 95 95 95 95 95 95 95 95 95 95 95 95 95 95 95 95 95 95 95 95 95 95 95 217 0 0 0 0 0 0 
95 95 95 95 95 95 95 95 96 256 256 256 256 256 256 256 256 256 256 256 256 256 256 256 256 256 256 256 256 256 256 256 256 257 0 0 0 0 0 0 
95 95 95 95 95 95 95 95 217 689 811 0 0 0 0 0 0 0 809 689 689 811 0 0 0 0 0 0 0 809 689 689 811 0 0 0 0 0 0 0 
95 95 95 95 95 95 95 95 217 689 811 0 0 0 0 0 0 0 809 689 689 811 0 0 0 0 0 0 0 809 689 689 811 0 0 0 0 0 0 0 
95 95 95 95 95 95 95 95 217 689 811 0 0 0 0 0 0 0 809 689 689 811 0 0 0 0 0 0 0 809 689 689 811 0 0 0 0 0 0 0 
256 256 256 256 256 256 256 256 257 689 811 0 0 0 0 0 0 0 809 689 689 811 0 0 0 0 0 0 0 809 689 689 811 0 0 0 0 0 0 0 
0 0 0 0 0 0 0 809 689 689 811 0 0 0 0 0 0 0 809 689 689 811 0 0 0 0 0 0 0 809 689 689 811 0 0 0 0 0 0 0 
0 0 0 0 0 0 0 809 689 689 811 0 0 0 0 0 0 0 809 689 689 811 0 0 0 0 0 0 0 809 689 175 176 176 176 176 176 176 176 176 
0 0 0 0 0 0 0 809 689 689 811 0 0 0 0 0 0 0 809 689 689 811 0 0 0 0 0 0 0 809 689 215 95 95 95 95 95 95 95 95 
0 0 0 0 0 0 0 809 689 689 811 0 0 0 0 0 0 0 809 689 689 811 0 0 0 0 0 0 0 809 689 215 95 95 95 95 95 95 95 95 
0 0 0 0 0 0 0 809 689 689 811 0 0 0 0 0 0 0 809 689 689 811 0 0 0 0 0 0 0 809 689 215 95 95 95 95 95 95 95 95 
0 0 0 0 0 0 175 176 176 176 176 176 176 176 176 176 176 176 176 176 176 176 176 176 176 176 176 176 176 176 176 137 95 95 95 95 95 95 95 95 
0 0 0 0 0 0 215 95 95 95 95 95 95 95 95 95 95 95 95 95 95 95 95 95 95 95 95 95 95 95 95 95 95 95 95 95 95 95 95 95 
0 0 0 0 0 0 215 95 95 95 95 95 95 95 95 95 95 95 95 95 95 95 95 95 95 95 95 95 95 95 95 95 95 95 95 95 95 95 95 95 
0 0 0 0 0 0 215 95 95 95 95 95 95 95 95 95 95 95 95 95 95 95 95 95 95 95 95 95 95 95 95 95 95 95 95 95 95 95 95 95 
176 176 176 176 176 176 137 95 95 95 95 95 95 95 95 95 95 95 95 95 95 95 95 95 95 95 95 95 95 95 95 95 95 95 95 95 95 95 95 95 
95 95 95 95 95 95 95 95 95 95 95 95 95 95 95 95 95 95 95 95 95 95 95 95 95 95 95 95 95 95 95 95 95 95 95 95 95 95 95 95 
95 95 95 95 95 95 95 95 95 95 95 95 95 95 95 95 95 95 95 95 95 95 95 95 95 95 95 95 95 95 95 95 95 95 95 95 95 95 95 95 
95 95 95 95 95 95 95 95 95 95 95 95 95 95 95 95 95 95 95 95 95 95 95 95 95 95 95 95 95 95 95 95 95 95 95 95 95 95 95 95 
95 95 95 95 95 95 95 95 95 95 95 95 95 95 95 95 95 95 95 95 95 95 95 95 95 95 95 95 95 95 95 95 95 95 95 95 95 95 95 95 
95 95 95 95 95 95 95 95 95 95 95 95 95 95 95 95 95 95 95 95 95 95 95 95 95 95 95 95 95 95 95 95 95 95 95 95 95 95 95 95 
4
10 11 1 3 5 48 80 272 152
28 16 1 2 5 48 80 272 152
36 13 10 1
2 14 10 0
