310 310 432 0 0 0 0 0 0 0 0 0 0 0 0 0 0 0 0 0 0 0 0 0 0 0 0 0 0 0 0 0 0 0 0 0 0 430 310 310 
310 310 432 0 0 0 0 0 0 0 0 0 0 0 0 0 0 0 0 0 0 0 0 0 0 0 0 0 0 0 0 0 0 0 0 0 0 430 310 310 
310 310 432 0 0 0 0 0 0 0 0 0 0 0 0 0 0 0 0 0 0 0 0 0 0 0 0 0 0 0 0 0 0 0 0 0 0 430 310 310 
310 310 432 0 0 0 0 0 0 0 0 0 0 0 0 0 0 0 0 0 0 0 0 0 0 0 0 0 0 0 0 0 0 0 0 0 0 430 310 310 
310 310 432 0 0 0 0 0 0 0 0 0 0 0 0 0 0 0 0 0 0 0 0 0 0 0 0 0 0 0 0 0 0 0 0 0 0 430 310 310 
310 310 432 0 0 0 0 0 0 0 0 0 0 0 0 0 0 0 0 0 0 0 772 773 773 773 773 773 773 773 773 773 773 773 773 773 773 430 310 310 
310 310 432 0 0 0 0 0 0 0 0 0 0 0 0 0 0 0 0 0 0 0 812 692 692 692 692 692 692 692 692 692 692 692 692 692 692 430 310 310 
310 310 432 0 0 0 0 0 0 0 0 0 0 0 0 0 0 0 0 0 0 0 812 692 692 692 692 692 692 692 692 692 692 692 692 692 692 430 310 310 
310 310 432 0 0 0 0 0 0 0 0 0 0 0 0 0 0 0 0 0 0 0 812 692 692 692 692 692 692 692 692 692 692 692 692 692 692 430 310 310 
310 310 432 0 0 0 0 0 0 0 0 0 0 0 0 0 0 0 0 0 0 0 812 692 692 692 692 692 692 692 692 692 692 692 692 692 692 430 310 310 
310 310 432 0 0 0 0 0 0 0 0 0 0 0 0 0 0 0 0 0 0 0 812 692 692 692 692 692 692 692 692 692 692 692 692 692 692 430 310 310 
310 310 432 0 0 0 0 0 0 0 0 0 0 0 0 0 0 0 0 0 0 0 812 692 692 692 692 692 692 692 692 692 692 692 692 692 692 430 310 310 
310 310 432 0 0 0 0 0 0 0 0 0 0 0 0 0 0 0 0 0 0 0 812 692 692 692 692 692 692 692 692 692 692 692 692 692 692 430 310 310 
310 310 432 0 0 0 0 0 0 0 0 0 0 0 0 0 0 0 0 0 0 0 852 853 853 853 853 694 692 692 692 692 692 692 692 692 692 430 310 310 
310 310 432 0 0 0 0 0 0 0 0 0 0 0 0 0 0 0 0 0 0 0 0 0 0 0 0 812 692 692 692 692 692 692 692 692 692 430 310 310 
310 310 432 0 0 0 0 0 0 0 0 0 0 0 0 0 0 0 0 0 0 0 0 0 0 0 0 812 692 692 692 692 692 692 692 692 692 430 310 310 
310 310 432 0 0 0 0 0 0 0 0 0 0 0 0 0 0 0 0 0 0 0 0 0 0 0 0 812 692 692 692 692 692 692 692 692 692 430 310 310 
310 310 432 0 0 0 0 0 0 0 0 0 0 0 0 0 0 0 0 0 0 0 0 0 0 0 0 812 692 692 692 692 692 692 692 692 692 430 310 310 
310 310 432 773 773 773 773 773 773 774 0 0 0 0 0 0 0 0 0 0 0 0 0 0 0 0 0 812 692 692 692 692 692 692 692 692 692 430 310 310 
310 310 432 692 692 692 692 692 692 814 0 0 0 0 0 0 0 0 0 0 0 0 0 0 0 0 0 812 692 692 692 692 692 692 692 692 692 430 310 310 
310 310 432 692 692 692 692 692 692 814 0 0 0 0 0 0 0 0 0 0 0 0 0 0 0 0 0 812 692 692 692 692 692 692 692 692 692 430 310 310 
310 310 432 692 692 692 692 692 692 814 0 0 0 0 0 0 0 0 0 0 0 0 0 0 0 0 0 812 692 692 692 692 692 692 692 692 692 430 310 310 
310 310 432 692 692 692 692 692 692 814 0 0 0 0 0 0 0 0 0 0 0 0 0 0 0 0 0 812 692 692 692 692 692 692 692 692 692 430 310 310 
310 310 432 692 692 692 692 692 692 814 0 0 0 0 0 0 0 0 0 0 0 0 0 0 0 0 0 812 692 692 692 692 692 692 692 692 692 430 310 310 
310 310 432 692 692 692 692 692 692 814 0 0 0 0 0 0 0 0 0 0 0 0 0 0 0 0 0 812 692 692 692 692 692 692 692 692 692 430 310 310 
310 310 432 692 692 692 692 692 692 814 0 0 0 0 0 0 0 0 0 0 0 0 0 0 0 0 0 812 692 692 692 692 692 692 692 692 692 430 310 310 
310 310 432 692 692 692 692 692 692 814 0 0 0 0 0 0 0 0 0 0 0 0 0 0 0 0 0 812 692 692 692 692 692 692 692 692 692 430 310 310 
310 310 432 692 692 692 692 692 692 814 0 0 0 0 0 0 0 0 0 0 0 0 0 0 0 0 0 812 692 692 692 692 692 692 692 692 692 430 310 310 
310 310 432 692 692 692 692 692 692 814 0 0 0 0 0 0 0 0 0 0 0 0 0 0 0 0 0 812 692 692 692 692 692 692 692 692 692 430 310 310 
0
