92 92 92 92 92 92 92 92 92 92 92 92 92 92 92 92 92 92 92 92 92 92 92 92 92 92 92 214 0 0 0 0 0 0 0 0 212 92 92 92 
253 253 253 253 253 253 253 253 253 253 253 253 253 253 253 253 253 253 253 253 253 253 253 253 253 253 253 254 0 0 0 0 0 0 0 0 212 92 92 92 
9 9 9 9 9 9 9 9 9 9 9 9 9 9 9 9 9 9 9 9 9 9 9 9 9 9 9 9 0 0 0 0 0 0 0 0 212 92 92 92 
0 0 0 0 0 0 0 0 0 0 0 0 0 0 0 0 0 0 0 0 0 0 0 0 0 0 0 0 0 0 0 0 0 0 0 0 212 92 92 92 
0 0 0 0 0 0 0 0 0 0 0 0 0 0 0 0 0 0 0 0 0 0 0 0 0 0 0 0 0 0 0 0 0 0 0 0 212 92 92 92 
0 0 0 0 0 0 0 0 0 0 0 0 0 0 0 0 0 0 0 0 0 0 0 0 0 0 0 0 763 764 764 764 764 764 764 764 212 92 92 92 
0 0 0 0 0 0 0 0 0 0 0 0 0 0 0 0 0 0 0 0 0 0 0 0 0 0 0 0 803 683 683 683 683 683 683 683 212 92 92 92 
0 0 0 0 0 0 0 0 0 0 0 0 0 0 0 0 0 0 0 0 0 0 0 0 0 0 0 0 803 683 683 683 683 683 683 683 212 92 92 92 
0 0 0 0 0 0 0 0 0 0 0 0 0 0 0 0 0 0 0 0 0 0 0 0 0 0 0 0 803 683 683 683 683 683 683 683 212 92 92 92 
0 0 0 0 0 0 0 0 0 0 0 0 0 0 0 0 0 0 0 0 0 0 0 0 0 0 0 0 803 683 683 683 683 683 683 683 212 92 92 92 
0 0 0 0 0 0 0 0 0 0 0 0 0 0 0 0 0 0 0 0 0 0 0 0 0 0 0 0 803 683 683 683 683 683 683 683 212 92 92 92 
0 0 0 0 0 0 0 0 0 0 0 0 0 0 0 0 0 0 0 0 0 0 0 0 0 0 172 173 173 173 173 174 683 683 683 683 212 92 92 92 
0 0 0 0 0 0 0 0 0 0 0 0 0 0 0 0 0 0 0 0 0 0 0 0 0 0 212 92 92 92 92 214 683 683 683 683 212 92 92 92 
0 0 0 0 0 0 0 0 0 0 0 0 0 0 0 0 0 0 0 0 0 0 0 0 0 0 212 92 92 92 92 214 683 683 683 683 212 92 92 92 
0 0 0 0 0 0 0 0 0 0 0 0 0 0 0 0 0 0 0 0 0 0 0 0 0 0 212 92 92 92 92 214 683 683 683 683 212 92 92 92 
0 0 0 0 0 0 0 0 0 0 0 0 0 0 0 0 0 0 0 0 0 0 0 0 0 0 212 92 92 92 92 214 683 683 683 683 212 92 92 92 
0 0 0 0 0 0 0 0 0 0 0 0 0 0 0 0 0 0 0 0 0 0 0 0 0 0 212 92 92 92 92 214 683 683 683 683 212 92 92 92 
0 0 0 0 0 0 0 0 0 0 0 0 0 0 0 0 0 0 0 0 0 0 0 0 0 0 252 253 253 253 253 254 683 683 683 683 212 92 92 92 
0 0 0 0 0 0 0 0 0 0 0 0 0 0 0 0 0 0 0 0 0 0 0 0 0 0 0 0 803 683 683 683 683 683 683 683 212 92 92 92 
0 0 0 0 0 0 0 0 0 0 0 0 0 0 0 0 0 0 0 0 0 0 0 0 0 0 0 0 803 683 683 683 683 683 683 683 212 92 92 92 
0 0 0 0 0 0 0 0 0 0 0 0 0 0 0 0 0 8 8 8 8 8 8 8 0 0 0 0 843 844 844 844 844 844 844 844 212 92 92 92 
0 0 0 0 0 0 0 0 0 0 0 0 0 0 0 0 0 172 173 173 173 173 173 174 0 0 0 0 0 0 0 0 0 0 0 0 212 92 92 92 
0 0 0 0 0 0 0 0 0 0 0 0 0 0 0 0 0 212 92 92 92 92 92 214 8 8 8 8 8 8 8 8 8 8 8 8 212 92 92 92 
0 0 0 0 0 0 0 0 0 0 0 0 0 0 0 0 0 212 92 92 92 92 92 133 173 173 173 173 173 173 173 173 173 173 173 173 134 92 92 92 
0 0 0 0 0 0 0 0 0 0 0 0 0 0 0 0 0 212 92 92 92 92 92 92 92 92 92 92 92 92 92 92 92 92 92 92 92 92 92 92 
8 8 8 8 8 8 8 8 8 8 8 8 8 8 8 8 8 212 92 92 92 92 92 92 92 92 92 92 92 92 92 92 92 92 92 92 92 92 92 92 
173 173 173 173 173 173 173 173 173 173 173 173 173 173 173 173 173 134 92 92 92 92 92 92 92 92 92 92 92 92 92 92 92 92 92 92 92 92 92 92 
92 92 92 92 92 92 92 92 92 92 92 92 92 92 92 92 92 92 92 92 92 92 92 92 92 92 92 92 92 92 92 92 92 92 92 92 92 92 92 92 
92 92 92 92 92 92 92 92 92 92 92 92 92 92 92 92 92 92 92 92 92 92 92 92 92 92 92 92 92 92 92 92 92 92 92 92 92 92 92 92 
8
0 13 2 8 4 0 0 320 240
8 13 2 6 4 0 0 320 240
0 14 2 7 4 0 0 320 240
8 14 2 5 4 0 0 320 240
17 13 2 0 5 136 88 200 152
21 13 2 0 5 136 88 200 152
10 14 2 5 4 0 0 320 240
10 13 2 6 4 0 0 320 240
