217 49 0 0 0 0 50 215 95 95 95 95 95 95 95 95 95 217 0 0 0 0 0 215 95 95 95 95 95 95 95 95 95 95 95 95 95 95 95 95 
217 49 0 0 0 0 50 215 95 95 95 95 95 95 95 95 95 217 0 0 0 0 0 215 95 95 95 95 95 95 95 95 95 95 95 95 95 95 95 95 
217 49 0 0 0 0 50 215 95 95 95 95 95 95 95 95 95 217 0 0 0 0 0 215 95 95 95 95 95 95 95 95 95 95 95 95 95 95 95 95 
217 49 0 0 0 0 50 215 95 95 95 95 95 95 95 95 95 217 0 0 0 0 0 215 95 95 95 95 95 95 95 95 95 95 95 95 95 95 95 95 
217 49 0 0 0 0 50 215 95 95 95 95 95 95 95 95 95 217 0 0 0 0 0 215 95 95 95 95 95 95 95 95 95 95 95 95 95 95 95 95 
217 49 0 0 0 0 50 215 95 95 95 95 95 95 95 95 95 217 0 0 0 0 0 215 95 95 95 95 95 95 95 95 95 95 95 95 95 95 95 95 
217 49 0 0 0 0 50 215 95 95 95 95 95 95 95 95 95 217 0 0 0 0 50 215 95 95 95 95 95 95 95 95 95 95 95 95 95 95 95 95 
217 49 0 0 0 0 50 215 95 95 95 95 95 95 95 95 95 217 0 0 0 0 50 215 95 95 95 95 95 95 95 95 95 95 95 95 95 95 95 95 
217 49 0 0 0 0 50 215 95 95 95 95 95 95 95 95 95 217 0 0 0 0 50 215 95 95 95 95 95 95 95 95 95 95 95 95 95 95 95 95 
217 49 0 0 0 0 50 215 95 95 95 95 95 95 95 95 95 217 0 0 0 0 50 215 95 95 95 95 95 95 95 95 95 95 95 95 95 95 95 95 
217 49 0 0 0 0 50 215 95 95 95 95 95 95 95 95 95 217 0 0 0 0 50 215 95 95 95 95 95 95 95 95 95 95 95 95 95 95 95 95 
217 49 0 0 0 0 50 215 95 95 95 95 95 95 95 95 95 217 0 0 0 0 50 215 95 95 95 95 95 95 95 95 95 95 95 95 95 95 95 95 
217 49 0 0 0 0 50 215 95 95 95 95 95 95 95 95 95 217 49 0 0 0 50 215 95 95 95 95 95 95 95 95 95 95 95 95 95 95 95 95 
217 49 0 0 0 0 50 215 95 95 95 95 95 95 95 95 95 217 49 0 0 0 50 215 95 95 95 95 95 95 95 95 95 95 95 95 95 95 95 95 
217 49 0 0 0 0 50 215 95 95 95 95 95 95 95 95 95 217 49 0 0 0 50 215 95 95 95 95 95 95 95 95 95 95 95 95 95 95 95 95 
217 49 0 0 0 0 50 215 95 95 95 95 95 95 95 95 95 217 49 0 0 0 50 215 95 95 95 95 95 95 95 95 95 95 95 95 95 95 95 95 
217 49 0 0 0 0 50 215 95 95 95 95 95 95 95 95 95 217 49 0 0 0 50 215 95 95 95 95 95 95 95 95 95 95 95 95 95 95 95 95 
217 49 0 0 0 0 50 215 95 95 95 95 95 95 95 95 95 217 49 0 0 0 0 215 95 95 95 95 95 95 95 95 95 95 95 95 95 95 95 95 
217 49 0 0 0 0 50 215 95 95 95 95 95 95 95 95 95 217 49 0 0 0 0 215 95 95 95 95 95 95 95 95 95 95 95 95 95 95 95 95 
217 49 0 0 0 0 50 215 95 95 95 95 95 95 95 95 95 217 49 0 0 0 0 215 95 95 95 95 95 95 95 95 95 95 95 95 95 95 95 95 
217 49 0 0 0 0 50 215 95 95 95 95 95 95 95 95 95 217 49 0 0 0 0 215 95 95 95 95 95 95 95 95 95 95 95 95 95 95 95 95 
217 49 0 0 0 0 50 215 95 95 95 95 95 95 95 95 95 217 49 0 0 0 0 215 95 95 95 95 95 95 95 95 95 95 95 95 95 95 95 95 
217 49 0 0 0 0 50 215 95 95 95 95 95 95 95 95 95 217 49 0 0 0 0 215 95 95 95 95 95 95 95 95 95 95 95 95 95 95 95 95 
217 49 0 0 0 0 50 215 95 95 95 95 95 95 95 95 95 217 0 0 0 0 0 215 95 95 95 95 95 95 95 95 95 95 95 95 95 95 95 95 
217 49 0 0 0 0 50 215 95 95 95 95 95 95 95 95 95 217 0 0 0 0 0 215 95 95 95 95 95 95 95 95 95 95 95 95 95 95 95 95 
217 49 0 0 0 0 50 215 95 95 95 95 95 95 95 95 95 217 0 0 0 0 0 215 95 95 95 95 95 95 95 95 95 95 95 95 95 95 95 95 
217 49 0 0 0 0 50 215 95 95 95 95 95 95 95 95 95 217 0 0 0 0 0 215 95 95 95 95 95 95 95 95 95 95 95 95 95 95 95 95 
217 49 0 0 0 0 50 215 95 95 95 95 95 95 95 95 95 217 0 0 0 0 0 215 95 95 95 95 95 95 95 95 95 95 95 95 95 95 95 95 
217 49 0 0 0 0 50 215 95 95 95 95 95 95 95 95 95 217 0 0 0 0 0 215 95 95 95 95 95 95 95 95 95 95 95 95 95 95 95 95 
0
