211 49 0 0 0 0 50 209 89 89 89 89 89 89 89 89 211 49 0 0 0 0 0 0 0 0 0 0 0 0 0 50 209 89 89 89 89 89 89 89 
211 49 0 0 0 0 50 209 89 89 89 89 89 89 89 89 211 49 0 0 0 0 0 0 0 0 0 0 0 0 0 50 209 89 89 89 89 89 89 89 
211 49 0 0 0 0 50 209 89 89 89 89 89 89 89 89 211 49 0 0 0 0 0 0 0 0 0 0 0 0 0 50 209 89 89 89 89 89 89 89 
211 49 0 0 0 0 50 209 89 89 89 89 89 89 89 89 211 49 0 0 0 0 0 0 0 0 0 0 0 0 0 50 209 89 89 89 89 89 89 89 
211 49 0 0 0 0 50 209 89 89 89 89 89 89 89 89 211 49 0 0 0 0 0 0 0 0 0 0 0 0 0 50 209 89 89 89 89 89 89 89 
211 49 0 0 0 0 50 209 89 89 89 89 89 89 89 89 211 49 0 0 0 0 0 0 0 0 0 0 0 0 0 50 209 89 89 89 89 89 89 89 
211 49 0 0 0 0 50 209 89 89 89 89 89 89 89 89 211 49 0 0 0 0 0 0 0 0 0 0 0 0 0 50 209 89 89 89 89 89 89 89 
211 49 0 0 0 0 50 209 89 89 89 89 89 89 89 89 211 49 0 0 0 0 0 0 0 0 0 0 0 0 0 50 209 89 89 89 89 89 89 89 
211 49 0 0 0 0 50 209 89 89 89 89 89 89 89 89 211 49 0 0 0 0 0 0 0 0 0 0 0 0 0 50 209 89 89 89 89 89 89 89 
211 49 0 0 0 0 50 209 89 89 89 89 89 89 89 89 211 49 0 0 0 0 0 0 0 0 0 0 0 0 0 50 209 89 89 89 89 89 89 89 
211 49 0 0 0 0 50 209 89 89 89 89 89 89 89 89 211 49 0 0 0 0 0 0 0 0 0 0 0 0 0 50 209 89 89 89 89 89 89 89 
211 49 0 0 0 0 50 209 89 89 89 89 89 89 89 89 211 49 0 0 0 0 0 0 0 0 0 0 0 0 0 50 209 89 89 89 89 89 89 89 
211 49 0 0 0 0 50 209 89 89 89 89 89 89 89 89 211 49 0 0 0 0 0 0 0 0 0 0 0 0 0 50 209 89 89 89 89 89 89 89 
211 49 0 0 0 0 50 209 89 89 89 89 89 89 89 89 211 49 0 0 0 0 0 0 0 0 0 0 0 0 0 50 209 89 89 89 89 89 89 89 
211 49 0 0 0 0 50 249 250 250 250 250 250 250 250 250 251 49 0 0 0 0 0 0 0 0 0 0 0 0 0 50 249 250 250 250 250 91 89 89 
211 49 0 0 0 0 0 0 0 0 0 0 0 0 0 0 0 0 0 0 0 0 0 0 0 0 0 0 0 0 0 0 0 0 0 0 0 209 89 89 
211 49 0 0 0 0 0 0 0 0 0 0 0 0 0 0 0 0 0 0 0 0 0 0 0 0 0 0 0 0 0 0 0 0 0 0 0 209 89 89 
211 49 0 0 0 0 0 0 0 0 0 0 0 0 0 0 0 0 0 0 0 0 0 0 0 0 0 0 0 0 0 0 0 0 0 0 0 209 89 89 
211 49 0 0 0 0 0 0 0 0 0 0 0 0 0 0 0 0 0 0 0 0 0 0 0 0 0 0 0 0 0 0 0 0 0 0 0 209 89 89 
211 49 0 0 0 0 0 0 0 0 0 0 0 0 0 0 0 0 0 0 0 0 0 0 0 0 0 0 0 0 0 0 0 0 0 0 0 209 89 89 
211 49 0 0 0 0 0 0 0 0 0 0 0 0 0 0 0 0 0 0 0 0 0 0 210 0 0 0 0 0 0 0 0 0 0 0 0 209 89 89 
130 170 170 170 170 170 171 0 0 0 0 169 170 170 170 170 170 170 170 170 170 170 170 170 170 170 170 170 170 170 170 170 171 0 0 0 0 209 89 89 
89 89 89 89 89 89 211 0 0 0 0 249 250 250 250 250 250 250 250 250 250 250 250 250 250 250 250 250 250 250 250 250 251 0 0 0 0 209 89 89 
89 89 89 89 89 89 211 0 0 0 0 0 0 0 0 0 0 0 0 0 0 0 0 0 0 0 0 0 0 0 0 0 0 0 0 0 0 209 89 89 
89 89 89 89 89 89 211 0 0 0 0 0 0 0 0 0 0 0 0 0 0 0 0 0 0 0 0 0 0 0 0 0 0 0 0 0 0 209 89 89 
89 89 89 89 89 89 211 0 0 0 0 0 0 0 0 0 0 0 0 0 0 0 0 0 0 0 0 0 0 0 0 0 0 0 0 0 0 209 89 89 
89 89 89 89 89 89 211 0 0 0 0 0 0 0 0 0 0 0 0 0 0 0 0 0 0 0 0 0 0 0 0 0 0 0 0 0 0 209 89 89 
89 89 89 89 89 89 211 8 8 8 8 8 8 8 8 8 8 8 8 8 8 8 8 8 8 8 8 8 8 169 170 170 170 170 170 170 170 131 89 89 
89 89 89 89 89 89 130 170 170 170 170 170 170 170 170 170 170 170 170 170 170 170 170 170 170 170 170 170 170 131 89 89 89 89 89 89 89 89 89 89 
2
28 18 9
12 19 10 1
