86 86 86 86 86 86 86 86 86 86 86 86 86 86 86 86 86 86 86 86 86 86 86 86 86 86 86 86 86 86 86 86 208 0 0 0 0 206 86 412 
86 87 247 247 247 247 247 247 247 247 247 247 247 247 88 86 86 86 86 86 87 247 247 247 247 88 86 86 87 247 247 247 248 0 0 0 0 206 86 412 
86 208 0 0 0 0 0 0 0 0 0 0 0 0 206 86 87 247 247 247 248 9 9 9 9 246 247 247 248 9 9 9 9 0 0 0 0 206 86 412 
86 208 0 0 0 0 0 0 0 0 0 0 0 0 206 86 208 0 0 0 0 0 0 0 0 0 0 0 0 0 0 0 0 0 0 0 0 206 86 412 
86 208 0 0 0 0 0 0 0 0 0 0 0 0 206 86 208 0 0 0 0 0 0 0 0 0 0 0 0 0 0 0 0 0 0 0 0 206 86 412 
86 208 0 0 0 0 0 0 0 0 0 0 0 0 206 86 208 0 0 0 0 0 0 0 0 0 0 0 0 0 0 0 0 0 0 0 0 206 86 412 
86 208 0 0 0 166 167 167 167 167 167 167 167 167 128 86 208 0 0 0 0 0 0 0 0 0 0 0 0 0 0 0 0 0 0 0 0 206 86 412 
86 208 0 0 0 206 372 373 373 373 373 373 373 373 373 374 208 0 0 0 0 0 0 0 0 0 0 0 0 0 0 0 0 0 0 0 0 206 86 412 
86 208 0 0 0 206 452 453 453 294 292 292 292 292 292 414 208 0 0 0 0 0 0 0 0 0 0 0 0 0 0 0 0 0 0 0 0 206 86 412 
86 208 0 0 0 246 247 247 88 452 453 453 294 292 292 414 208 0 0 0 0 166 167 167 168 8 8 8 8 166 167 167 167 167 167 167 167 128 86 412 
86 208 0 0 0 0 0 0 246 247 247 88 452 453 453 454 208 0 0 0 0 206 86 86 127 167 167 167 167 128 86 86 86 86 86 86 86 86 86 412 
86 208 0 0 0 0 0 0 9 9 9 246 247 247 88 86 208 0 0 0 0 206 86 86 86 86 86 86 86 86 86 86 86 86 86 86 86 86 86 412 
86 208 0 0 0 0 0 0 0 0 0 0 0 0 246 247 248 0 0 0 0 206 86 372 373 373 373 373 373 373 373 373 373 373 373 373 373 373 373 334 
86 208 0 0 0 0 0 0 0 0 0 0 0 0 9 9 9 0 0 0 0 206 86 412 292 292 292 292 292 292 292 292 292 292 292 292 292 292 292 292 
86 208 0 0 0 0 0 0 0 0 0 0 0 0 0 0 0 0 0 0 0 206 86 412 292 292 292 292 292 292 292 292 292 292 292 292 292 292 292 292 
86 208 0 0 0 0 0 0 0 0 0 0 0 0 0 0 0 0 0 0 0 206 86 412 292 292 292 292 292 292 292 292 292 292 292 292 292 292 292 292 
86 208 0 0 0 0 0 0 0 0 0 0 0 0 0 0 0 0 0 0 0 206 86 412 292 292 292 292 292 292 292 292 292 292 292 292 292 292 292 292 
86 208 0 0 0 0 0 0 0 0 0 0 0 0 0 0 0 0 0 0 0 206 86 412 292 292 292 292 292 292 292 292 292 292 292 292 292 292 292 292 
86 208 0 0 0 0 0 0 0 0 0 0 0 0 0 0 0 0 0 0 0 206 86 412 292 292 292 292 292 292 292 292 292 292 292 292 292 292 292 292 
86 208 0 0 0 0 0 0 0 0 0 0 0 0 0 0 0 0 0 0 0 206 86 412 292 292 292 292 292 292 292 292 292 292 292 292 292 292 292 292 
86 208 0 0 0 0 0 0 0 0 0 0 0 0 0 0 0 0 0 0 0 206 86 412 292 292 292 292 292 292 292 292 292 292 292 292 292 292 292 292 
86 127 167 167 168 8 8 8 0 0 0 0 0 0 0 0 0 0 0 0 0 206 86 412 292 292 292 292 292 292 292 292 292 292 292 292 292 292 292 292 
86 86 86 86 127 167 167 168 0 0 0 0 0 0 0 0 0 0 0 0 0 206 86 412 292 292 292 292 292 292 292 292 292 292 292 292 292 292 292 292 
373 373 374 86 86 86 86 127 167 167 168 8 8 8 0 0 0 0 0 0 0 206 86 412 292 292 292 292 292 292 292 292 292 292 292 292 292 292 292 292 
292 292 333 373 373 374 86 86 86 86 127 167 167 168 0 0 0 0 0 0 0 206 86 412 292 292 292 292 292 292 292 292 292 292 292 292 292 292 292 292 
292 292 292 292 292 333 373 373 374 86 86 86 86 127 167 167 168 0 0 0 0 206 86 412 292 292 292 292 292 292 292 292 292 292 292 292 292 292 292 292 
292 292 292 292 292 292 292 292 333 373 373 374 86 86 86 86 208 8 8 8 8 206 86 412 292 292 292 292 292 292 292 292 292 292 292 292 292 292 292 292 
292 292 292 292 292 292 292 292 292 292 292 333 373 373 374 86 127 167 167 167 167 128 86 412 292 292 292 292 292 292 292 292 292 292 292 292 292 292 292 292 
292 292 292 292 292 292 292 292 292 292 292 292 292 292 414 86 86 86 86 86 86 86 86 412 292 292 292 292 292 292 292 292 292 292 292 292 292 292 292 292 
7
10 3 9
12 13 8
15 23 8
9 21 8
6 11 8
3 19 8
34 7 10
