207 207 207 207 207 207 207 207 207 206 86 208 0 0 0 0 206 86 208 207 207 206 86 208 0 0 0 0 206 86 208 207 207 207 207 207 207 207 207 207 
207 207 207 207 207 207 207 207 207 206 86 208 0 0 0 0 206 86 208 207 207 206 86 208 0 0 0 0 206 86 208 207 207 207 207 207 207 207 207 207 
207 207 207 207 207 207 207 207 207 206 86 208 0 0 0 0 206 86 208 207 207 206 86 208 0 0 0 0 206 86 208 207 207 207 207 207 207 207 207 207 
207 207 207 207 207 207 207 207 207 206 86 208 0 0 0 0 206 86 208 207 207 206 86 208 0 0 0 0 206 86 208 207 207 207 207 207 207 207 207 207 
207 207 207 207 207 207 207 207 207 206 86 208 0 0 0 0 206 86 208 207 207 206 86 208 0 0 0 0 206 86 208 207 207 207 207 207 207 207 207 207 
207 207 207 207 207 207 207 207 207 206 86 208 0 0 0 0 206 86 208 207 207 206 86 208 0 0 0 0 206 86 208 207 207 207 207 207 207 207 207 207 
207 207 207 207 207 207 207 207 207 206 86 208 0 0 0 0 206 86 208 207 207 206 86 208 0 0 0 0 206 86 127 167 167 167 167 167 167 167 167 167 
207 207 207 207 207 207 207 207 207 206 86 208 0 0 0 0 206 86 208 207 207 206 86 208 0 0 0 0 206 86 86 86 86 86 86 86 86 86 86 86 
207 207 207 207 207 207 207 207 207 206 86 208 0 0 0 0 206 86 208 207 207 206 86 208 0 0 0 0 246 247 247 247 247 247 247 247 247 247 247 247 
167 167 167 167 167 167 167 167 167 128 86 208 0 0 0 0 206 86 127 167 167 128 86 208 0 0 0 0 7 7 7 7 7 7 7 7 7 7 7 7 
86 86 86 86 86 86 86 86 86 86 86 208 0 0 0 0 206 86 86 86 86 86 86 208 0 0 0 0 0 0 0 0 0 0 0 0 0 0 0 0 
247 247 247 247 247 247 247 247 247 247 247 248 0 0 0 0 246 247 247 247 247 247 247 248 0 0 0 0 0 0 0 0 0 0 0 0 0 0 0 0 
7 7 7 7 7 7 7 7 7 7 7 7 0 0 0 0 7 7 7 7 7 7 7 7 0 0 0 0 0 0 0 0 0 0 0 0 0 0 0 0 
0 0 0 0 0 0 0 0 0 0 0 0 0 0 0 0 0 0 0 0 0 0 0 0 0 0 0 0 0 0 0 0 0 0 0 0 0 0 0 0 
0 0 0 0 0 0 0 0 0 0 0 0 0 0 0 0 0 0 0 0 0 0 0 0 0 0 0 0 0 0 0 0 0 0 0 0 0 0 0 0 
0 0 0 0 0 0 0 0 0 0 0 0 0 0 0 0 0 0 0 0 0 0 0 0 0 0 0 0 0 0 0 0 0 0 0 0 0 0 0 0 
6 6 6 6 6 6 6 6 6 6 6 6 0 0 0 0 0 0 0 0 0 0 0 0 0 0 0 0 6 6 6 6 6 6 6 6 6 6 6 6 
167 167 167 167 167 167 167 167 167 167 167 168 0 0 0 0 0 0 0 0 0 0 0 0 0 0 0 0 166 167 167 167 167 167 167 167 167 167 167 167 
86 86 86 86 86 86 86 86 86 86 86 208 0 0 0 0 0 0 0 0 0 0 0 0 0 0 0 0 206 86 86 86 86 86 86 86 86 86 86 86 
247 247 247 247 247 247 247 247 247 88 86 208 0 0 0 0 6 6 6 6 6 6 6 6 0 0 0 0 206 86 87 247 247 247 247 247 247 247 247 247 
207 207 207 207 207 207 207 207 207 206 86 208 0 0 0 0 166 167 167 167 167 167 167 168 0 0 0 0 206 86 208 207 207 207 207 207 207 207 207 207 
207 207 207 207 207 207 207 207 207 206 86 208 0 0 0 0 206 86 86 86 86 86 86 208 0 0 0 0 206 86 208 207 207 207 207 207 207 207 207 207 
207 207 207 207 207 207 207 207 207 206 86 208 0 0 0 0 206 86 87 247 247 88 86 208 0 0 0 0 206 86 208 207 207 207 207 207 207 207 207 207 
207 207 207 207 207 207 207 207 207 206 86 208 0 0 0 0 206 86 208 207 207 206 86 208 0 0 0 0 206 86 208 207 207 207 207 207 207 207 207 207 
207 207 207 207 207 207 207 207 207 206 86 208 0 0 0 0 206 86 208 207 207 206 86 208 0 0 0 0 206 86 208 207 207 207 207 207 207 207 207 207 
207 207 207 207 207 207 207 207 207 206 86 208 0 0 0 0 206 86 208 207 207 206 86 208 0 0 0 0 206 86 208 207 207 207 207 207 207 207 207 207 
207 207 207 207 207 207 207 207 207 206 86 208 0 0 0 0 206 86 208 207 207 206 86 208 0 0 0 0 206 86 208 207 207 207 207 207 207 207 207 207 
207 207 207 207 207 207 207 207 207 206 86 208 0 0 0 0 206 86 208 207 207 206 86 208 0 0 0 0 206 86 208 207 207 207 207 207 207 207 207 207 
207 207 207 207 207 207 207 207 207 206 86 208 0 0 0 0 206 86 208 207 207 206 86 208 0 0 0 0 206 86 208 207 207 207 207 207 207 207 207 207 
1
1 14 2 3 4 -96 -72 400 312
