0 0 0 1 1 49 0 0 0 0 0 0 50 1 49 0 0 0 0 0 0 50 1 49 0 0 0 0 0 0 0 0 0 0 0 0 0 0 0 0 
0 0 0 1 1 49 0 0 0 0 0 0 50 1 49 0 0 0 0 0 0 50 1 49 0 0 0 0 0 0 0 0 0 0 0 0 0 0 0 0 
0 0 0 1 1 49 0 0 0 0 0 0 50 1 49 0 0 0 0 0 0 50 1 49 0 0 0 0 0 0 0 1 1 1 1 1 1 1 1 1 
0 0 0 1 1 49 0 0 0 0 0 0 50 1 49 0 0 0 0 0 0 50 1 49 0 0 0 0 0 0 0 1 1 1 1 1 1 1 1 1 
0 0 0 1 1 49 0 0 0 0 0 0 50 1 49 0 0 0 0 0 0 50 1 49 0 0 0 0 0 0 0 1 1 1 1 1 1 1 1 1 
0 0 0 1 1 49 0 0 0 0 0 0 50 1 49 0 0 0 0 0 0 50 1 49 0 0 0 0 0 0 0 1 1 1 1 1 1 1 1 1 
0 0 0 1 1 49 0 0 0 0 0 0 50 1 49 0 0 0 0 0 0 50 1 49 0 0 0 0 0 0 0 1 1 1 1 1 1 1 1 1 
0 0 0 1 1 49 0 0 0 0 0 0 50 1 49 0 0 0 0 0 0 50 1 49 0 0 0 0 0 0 0 0 0 0 0 0 0 0 0 0 
0 0 0 1 1 49 0 0 0 0 0 0 50 1 49 0 0 0 0 0 0 50 1 49 0 0 0 0 0 0 0 0 0 0 0 0 0 0 0 0 
0 0 0 1 1 49 0 0 0 0 0 0 50 1 49 0 0 0 0 0 0 50 1 49 0 0 0 0 0 0 0 0 0 0 0 0 0 0 0 0 
0 0 0 1 1 49 0 0 0 0 0 0 50 1 49 0 0 0 0 0 0 50 1 49 0 0 0 0 0 0 0 0 0 0 0 0 0 0 0 0 
0 0 0 1 1 49 0 0 0 0 0 0 50 1 49 0 0 0 0 0 0 50 1 49 0 0 0 0 0 0 0 0 0 0 0 0 0 0 0 0 
0 0 0 1 1 49 0 0 0 0 0 0 50 1 49 0 0 0 0 0 0 50 1 49 0 0 0 0 0 0 0 0 0 0 0 0 0 0 0 0 
0 0 0 1 1 49 0 0 0 0 0 0 0 9 0 0 0 0 0 0 0 0 9 0 0 0 0 0 0 0 0 0 0 0 0 0 0 0 0 0 
0 0 0 1 1 49 0 0 0 0 0 0 0 0 0 0 0 0 0 0 0 0 0 0 0 0 0 0 0 0 0 0 1 1 1 1 1 1 1 1 
0 0 0 1 1 49 0 0 0 0 0 0 0 0 0 0 0 0 0 0 0 0 0 0 0 0 0 0 0 0 0 0 1 1 1 1 1 1 1 1 
0 0 0 1 1 49 0 0 0 0 0 0 0 0 0 0 0 0 0 0 0 0 0 0 0 0 0 0 0 0 0 50 1 1 1 1 1 1 1 1 
0 0 0 1 1 49 0 0 0 0 0 0 0 0 0 0 0 0 0 0 0 0 0 0 0 0 0 0 0 0 0 50 1 1 1 1 1 1 1 1 
0 0 0 1 1 49 0 0 0 0 0 0 0 0 0 0 0 0 0 0 0 0 0 0 0 0 0 0 0 0 0 50 1 1 1 1 1 1 1 1 
0 0 0 1 1 49 0 0 0 0 0 0 0 0 0 0 0 0 0 0 0 0 0 0 0 0 0 0 0 0 0 50 1 1 1 1 1 1 1 1 
0 0 0 1 1 49 0 0 0 0 0 0 0 0 0 0 0 0 0 0 0 0 0 0 0 0 0 0 0 0 0 50 1 1 1 1 1 1 1 1 
0 0 0 1 1 49 0 0 0 0 0 0 0 0 0 0 0 0 0 0 0 0 0 0 0 0 0 0 0 0 0 50 1 1 1 1 1 1 1 1 
0 0 0 1 1 1 8 8 8 8 8 8 8 8 8 8 8 8 8 8 8 8 8 8 8 8 8 8 8 8 8 1 1 1 1 1 1 1 1 1 
0 0 0 1 1 1 1 1 1 1 1 1 1 1 1 1 1 1 1 1 1 1 1 1 1 1 1 1 1 1 1 1 1 1 1 1 1 1 1 1 
0 0 0 1 1 1 1 1 1 1 1 1 1 1 1 1 1 1 1 1 1 1 1 1 1 1 1 1 1 1 1 1 1 1 1 1 1 1 1 1 
0 0 0 1 1 1 1 1 1 1 1 1 1 1 1 1 1 1 1 1 1 1 1 1 1 1 1 1 1 1 1 1 1 1 1 1 1 1 1 1 
0 0 0 1 1 1 1 1 1 1 1 1 1 1 1 1 1 1 1 1 1 1 1 1 1 1 1 1 1 1 1 1 1 1 1 1 1 1 1 1 
0 0 0 1 1 1 1 1 1 1 1 1 1 1 1 1 1 1 1 1 1 1 1 1 1 1 1 1 1 1 1 1 1 1 1 1 1 1 1 1 
0 0 0 0 0 0 0 0 0 0 0 0 0 0 0 0 0 0 0 0 0 0 0 0 0 0 0 0 0 0 0 0 0 0 0 0 0 0 0 0 
3
24 5 11 56
6 19 11 200
34 12 10 1
