280 280 281 441 441 441 441 441 441 282 280 280 281 441 441 441 441 282 280 280 281 441 441 441 441 282 280 280 280 280 280 280 280 280 280 280 280 280 280 280 
280 280 402 0 0 0 0 0 0 400 280 280 402 64 64 64 64 400 280 280 402 64 64 64 64 440 441 441 441 441 441 441 441 441 441 441 441 441 282 280 
280 280 402 0 0 0 0 0 0 440 441 441 442 0 0 0 0 400 280 280 402 0 0 0 0 0 0 0 0 0 0 0 0 0 0 0 0 0 400 280 
280 280 402 0 0 0 0 0 0 0 0 0 0 0 0 0 0 440 441 441 442 0 0 0 0 0 0 0 0 0 0 0 0 0 0 0 0 0 400 280 
280 280 402 0 0 0 0 0 0 0 0 0 0 0 0 0 0 0 0 0 0 0 0 0 0 0 0 0 0 0 0 0 0 0 0 0 0 0 400 280 
280 280 402 0 0 0 0 0 0 0 0 0 0 0 0 0 0 0 0 0 0 0 0 0 0 0 0 0 0 0 0 0 0 0 0 0 0 0 400 280 
280 280 402 0 0 0 0 0 0 0 0 0 0 0 0 0 0 0 0 0 0 0 0 0 0 0 0 0 0 0 0 0 0 0 0 0 0 0 400 280 
280 280 402 0 0 0 0 0 0 0 0 0 0 0 0 0 0 0 0 0 0 0 0 0 0 0 0 0 0 0 0 0 0 0 0 0 0 0 400 280 
280 280 402 0 0 0 0 0 0 0 0 0 0 0 0 0 0 0 0 0 0 0 0 0 0 0 0 0 0 0 0 0 0 0 0 0 0 0 400 280 
280 280 402 0 0 0 0 0 0 0 0 0 0 0 0 0 0 0 0 0 0 0 0 0 0 0 0 0 0 0 0 0 0 0 0 0 0 0 400 280 
280 280 402 0 0 0 0 0 0 0 0 0 0 0 0 0 0 0 0 0 0 0 0 0 0 0 0 0 0 0 0 0 0 0 0 0 0 0 400 280 
280 280 402 0 0 0 0 0 0 0 0 0 0 0 0 0 0 0 0 0 0 384 0 0 0 0 384 0 0 0 0 360 362 0 0 0 0 0 400 280 
280 280 402 0 0 0 0 0 0 360 361 361 361 361 361 361 362 63 63 63 63 424 0 0 0 0 424 63 63 63 63 400 402 0 0 0 0 0 400 280 
280 280 402 0 0 0 0 0 0 400 280 280 280 280 280 280 280 305 305 305 305 442 0 0 0 0 440 305 305 305 305 280 402 0 0 0 0 0 400 280 
280 280 321 361 361 361 361 361 361 322 280 280 280 280 280 280 402 64 64 64 64 64 0 0 0 0 64 64 64 64 64 400 402 0 0 0 0 0 400 280 
280 280 280 280 280 280 280 280 281 441 441 441 441 441 441 441 442 0 0 0 0 0 0 0 0 0 0 0 0 0 0 440 442 0 0 0 0 0 400 280 
280 280 280 280 280 280 280 280 402 0 0 0 0 0 0 0 0 0 0 0 0 0 0 0 0 0 0 0 0 0 0 0 0 0 0 0 0 0 400 280 
280 280 280 280 280 280 280 280 402 0 0 0 0 0 0 0 0 0 0 0 0 0 0 0 0 0 0 0 0 0 0 0 0 0 0 0 0 0 400 280 
280 280 280 280 280 280 280 280 402 0 0 0 0 0 0 0 0 0 0 0 0 0 0 0 0 0 0 0 0 0 0 0 0 0 0 0 0 0 400 280 
280 280 280 280 280 280 280 280 402 0 0 0 0 0 360 361 362 0 0 0 0 0 0 0 0 0 0 0 0 0 0 0 0 0 0 0 0 0 400 280 
280 280 280 280 280 280 280 280 402 0 0 0 0 0 400 280 402 0 0 0 0 0 0 0 0 0 0 0 0 0 0 0 0 0 0 0 0 0 400 280 
280 280 280 280 280 280 280 280 402 0 0 0 0 0 400 280 402 0 0 0 0 0 0 0 0 0 0 0 0 0 0 0 0 0 0 0 0 0 400 280 
280 280 280 280 280 280 280 280 402 0 0 0 0 0 400 280 402 0 0 0 0 0 0 0 0 0 0 0 0 0 0 0 0 0 0 0 0 0 400 280 
280 280 280 280 280 280 280 280 402 0 0 0 0 0 400 280 402 63 63 63 63 63 63 63 63 63 63 63 63 63 63 63 63 63 63 63 63 63 400 280 
280 280 280 280 280 280 280 280 402 0 0 0 0 0 400 280 321 361 361 361 361 361 361 361 361 361 361 361 361 361 361 361 361 361 361 361 361 361 322 280 
280 280 280 280 280 280 280 280 402 0 0 0 0 0 400 280 280 280 280 280 280 280 280 280 280 280 280 280 280 280 280 280 280 280 280 280 280 280 280 280 
280 280 280 280 280 280 280 280 402 0 0 0 0 0 400 280 280 280 280 280 280 280 280 280 280 280 280 280 280 280 280 280 280 280 280 280 280 280 280 280 
280 280 280 280 280 280 280 280 402 0 0 0 0 0 400 280 280 280 280 280 280 280 280 280 280 280 280 280 280 280 280 280 280 280 280 280 280 280 280 280 
280 280 280 280 280 280 280 280 402 0 0 0 0 0 400 280 280 280 280 280 280 280 280 280 280 280 280 280 280 280 280 280 280 280 280 280 280 280 280 280 
5
34 3 9
4 3 2 0 1 32 24 64 96
3 7 11 280
22 11 2 0 1 176 88 208 128
17 19 11 168
