0 0 0 0 0 0 0 0 0 0 0 0 0 0 0 0 0 0 0 0 0 0 0 0 0 0 0 0 0 0 0 0 0 0 0 0 0 0 0 0 
1 1 1 1 1 1 1 1 1 1 1 1 1 1 1 1 1 1 1 1 1 1 1 1 1 1 1 1 1 1 1 1 1 1 1 0 0 0 0 0 
1 1 1 1 1 1 1 1 1 1 1 1 1 1 1 1 1 1 1 1 1 1 1 1 1 1 1 1 1 1 1 1 1 1 1 0 0 0 0 0 
9 9 9 9 9 9 9 1 1 1 9 9 9 9 9 1 1 1 9 9 9 9 9 1 1 1 9 9 9 9 9 1 1 1 1 0 0 0 0 0 
0 0 0 0 0 0 0 0 1 0 0 0 0 0 0 50 1 49 0 0 0 0 0 0 1 0 0 0 0 0 0 50 1 1 1 0 0 0 0 0 
0 0 0 0 0 0 0 0 0 0 0 0 0 0 0 50 1 49 0 0 0 0 0 0 0 0 0 0 0 0 0 50 1 1 1 0 0 0 0 0 
0 0 0 0 0 0 0 0 0 0 0 0 0 0 0 50 1 49 0 0 0 0 0 0 0 0 0 0 0 0 0 50 1 1 1 0 0 0 0 0 
0 0 0 0 0 0 0 0 0 0 0 0 0 0 0 50 1 49 0 0 0 0 0 0 0 0 0 0 0 0 0 50 1 1 1 0 0 0 0 0 
0 0 0 0 0 0 0 0 0 0 0 0 0 0 0 50 1 49 0 0 0 0 0 0 0 0 0 0 0 0 0 50 1 1 1 0 0 0 0 0 
0 0 0 0 0 0 0 0 0 0 0 0 0 0 0 50 1 49 0 0 0 0 0 0 0 0 0 0 0 0 0 50 1 1 1 0 0 0 0 0 
0 0 0 0 0 0 0 0 0 0 0 0 0 0 0 0 1 0 0 0 0 0 0 0 0 0 0 0 0 0 0 50 1 1 1 0 0 0 0 0 
0 0 0 0 0 0 0 0 0 0 0 0 0 0 0 0 0 0 0 0 0 0 0 0 0 0 0 0 0 0 0 50 1 1 1 0 0 0 0 0 
0 0 0 0 0 0 0 0 0 0 0 0 0 0 0 0 0 0 0 0 0 0 0 0 0 0 0 0 0 0 0 50 1 1 1 0 0 0 0 0 
0 0 0 0 0 0 0 0 0 0 0 0 0 0 0 0 0 0 0 0 0 0 0 0 0 0 0 0 0 0 0 50 1 1 1 0 0 0 0 0 
0 0 0 0 0 0 0 0 0 0 0 0 0 0 0 0 0 0 0 0 0 0 0 0 0 0 0 0 0 0 0 50 1 1 1 0 0 0 0 0 
0 0 0 0 0 0 0 0 0 0 0 0 0 0 0 0 0 0 0 0 0 0 0 0 0 0 0 0 0 0 0 50 1 1 1 0 0 0 0 0 
0 0 0 0 0 0 0 0 0 0 0 0 0 0 0 0 0 0 0 0 0 0 0 0 0 0 0 0 0 0 0 50 1 1 1 0 0 0 0 0 
0 0 0 0 0 0 0 0 1 0 0 0 0 0 0 0 0 0 0 0 0 0 0 0 1 0 0 0 0 0 0 50 1 1 1 0 0 0 0 0 
0 0 0 0 0 0 0 0 1 49 0 0 0 0 0 0 0 0 0 0 0 0 0 50 1 49 0 0 0 0 0 50 1 1 1 0 0 0 0 0 
0 0 0 0 0 0 0 0 1 49 0 0 0 0 0 0 0 0 0 0 0 0 0 50 1 49 0 0 0 0 0 50 1 1 1 0 0 0 0 0 
0 0 0 0 0 0 0 0 1 49 0 0 0 0 0 0 0 0 0 0 0 0 0 50 1 49 0 0 0 0 0 50 1 1 1 0 0 0 0 0 
0 0 0 0 0 0 0 0 1 49 0 0 0 0 0 0 0 0 0 0 0 0 0 50 1 49 0 0 0 0 0 50 1 1 1 0 0 0 0 0 
0 0 0 0 0 0 0 0 1 49 0 0 0 0 0 0 0 0 0 0 0 0 0 50 1 49 0 0 0 0 0 50 1 1 1 0 0 0 0 0 
0 0 0 0 0 0 0 0 1 49 0 0 0 0 0 0 1 0 0 0 0 0 0 50 1 49 0 0 0 0 0 50 1 1 1 0 0 0 0 0 
0 0 0 0 0 0 0 0 1 49 0 0 0 0 0 50 1 49 0 0 0 0 0 50 1 49 0 0 0 0 0 50 1 1 1 0 0 0 0 0 
1 1 1 1 1 1 1 1 1 1 8 8 8 8 8 1 1 49 0 0 0 0 0 50 1 1 8 8 8 8 8 1 1 1 1 0 0 0 0 0 
1 1 1 1 1 1 1 1 1 1 1 1 1 1 1 1 1 49 0 0 0 0 0 50 1 1 1 1 1 1 1 1 1 1 1 0 0 0 0 0 
1 1 1 1 1 1 1 1 1 1 1 1 1 1 1 1 1 49 0 0 0 0 0 50 1 1 1 1 1 1 1 1 1 1 1 0 0 0 0 0 
0 0 0 0 0 0 0 0 0 0 0 0 0 0 1 1 1 49 0 0 0 0 0 50 1 1 1 0 0 0 0 0 0 0 0 0 0 0 0 0 
5
2 23 10 1
8 5 12 96
16 11 12 96
24 5 12 96
26 22 11 40
