453 453 453 453 453 453 294 414 0 0 0 0 0 0 412 292 292 292 292 292 292 292 292 292 292 292 292 292 292 292 292 292 292 292 292 292 292 292 292 292 
72 72 0 0 0 0 412 414 0 0 0 0 0 0 412 292 292 292 292 292 292 292 292 292 292 292 292 292 292 292 292 292 292 292 292 292 292 292 292 292 
0 0 0 0 0 0 412 414 0 0 0 0 0 0 412 292 292 292 292 292 292 292 292 292 292 292 292 292 292 292 292 292 292 292 292 292 292 292 292 292 
0 0 0 0 0 0 412 414 0 0 0 0 0 0 412 292 292 292 292 292 292 292 292 292 292 292 292 292 292 292 292 292 292 292 292 292 292 292 292 292 
0 0 0 0 0 0 412 414 0 0 0 0 0 0 412 292 292 292 292 292 292 292 292 292 292 292 292 292 292 292 292 292 292 292 292 292 292 292 292 292 
0 0 0 0 0 0 412 414 0 0 0 0 0 0 412 292 292 292 292 292 292 292 292 292 292 292 292 292 292 292 292 292 292 292 292 292 292 292 292 292 
0 0 0 0 0 0 412 414 0 0 0 0 0 0 412 292 292 292 292 292 292 292 292 292 292 292 292 292 292 292 292 292 292 292 292 292 292 292 292 292 
0 0 0 0 0 0 412 414 0 0 0 0 0 0 412 292 292 292 292 292 292 292 292 292 292 292 292 292 292 292 292 292 292 292 292 292 292 292 292 292 
0 0 0 0 0 0 412 414 0 0 0 0 0 0 412 292 292 292 292 292 292 292 292 292 292 292 292 292 292 292 292 292 292 292 292 292 292 292 292 292 
0 0 0 0 0 0 412 414 0 0 0 0 0 0 412 292 292 292 292 292 292 292 292 292 292 292 292 292 292 292 292 292 292 292 292 292 292 292 292 292 
0 0 0 0 0 0 412 414 0 0 0 0 0 0 412 292 292 292 292 292 292 292 292 292 292 292 292 292 292 292 292 292 292 292 292 292 292 292 292 292 
0 0 0 0 0 0 412 414 0 0 0 0 0 0 412 292 292 292 292 292 292 292 292 292 292 292 292 292 292 292 292 292 292 292 292 292 292 292 292 292 
0 0 0 0 0 0 412 414 0 0 0 0 0 0 412 292 292 292 292 292 292 292 292 292 292 292 292 292 292 292 292 292 292 292 292 292 292 292 292 292 
0 0 0 0 0 0 412 414 0 0 0 0 0 0 412 293 453 453 453 294 292 293 453 453 453 294 292 293 453 453 453 294 292 292 292 292 292 292 292 292 
0 0 0 0 0 0 412 414 0 0 0 0 0 0 412 414 72 72 72 412 292 414 72 72 72 412 292 414 72 72 72 412 292 292 292 292 292 292 292 292 
373 374 0 0 0 0 412 414 0 0 0 0 0 0 452 454 0 0 0 452 453 454 0 0 0 452 453 454 0 0 0 452 453 453 453 453 453 453 294 292 
292 414 0 0 0 0 412 414 0 0 0 0 0 0 0 0 0 0 0 0 0 0 0 0 0 0 0 0 0 0 0 0 0 0 0 0 0 0 412 292 
292 414 0 0 0 0 412 414 0 0 0 0 0 0 0 0 0 0 0 0 0 0 0 0 0 0 0 0 0 0 0 0 0 0 0 0 0 0 412 292 
292 414 0 0 0 0 412 414 0 0 0 0 0 0 0 0 0 0 0 0 0 0 0 0 0 0 0 0 0 0 0 0 0 0 0 0 0 0 412 292 
292 414 0 0 0 0 412 414 0 0 0 0 0 0 0 0 0 0 0 0 0 0 0 0 0 0 0 0 0 0 0 0 0 71 71 0 0 0 412 292 
292 414 0 0 0 0 452 454 0 0 0 0 0 0 0 0 0 0 0 0 0 0 0 0 0 0 0 0 0 0 0 0 0 307 309 0 0 0 412 292 
292 414 0 0 0 0 72 72 0 0 0 0 0 0 0 0 0 0 0 0 0 0 0 0 0 0 0 0 0 0 0 0 0 72 72 0 0 0 412 292 
292 414 0 0 0 0 0 0 0 0 0 0 0 0 0 0 0 0 0 0 0 0 0 0 0 0 0 0 0 0 0 0 0 0 0 0 0 0 412 292 
292 414 0 0 0 0 0 0 0 0 0 0 0 0 0 0 0 0 0 0 0 0 0 0 0 0 0 0 0 0 0 0 0 0 0 0 0 0 412 292 
292 414 0 0 0 0 0 0 0 0 0 0 0 0 0 0 0 0 0 0 0 0 0 0 0 0 0 0 0 0 0 0 0 0 0 0 0 0 412 292 
292 333 373 373 373 373 373 373 373 373 374 0 0 0 0 0 0 372 373 373 373 373 374 0 0 0 0 0 0 372 373 373 373 373 373 373 373 373 334 292 
292 292 292 292 292 292 292 292 292 292 414 71 71 71 71 71 71 412 292 292 292 292 414 71 71 71 71 71 71 412 292 292 292 292 292 292 292 292 292 292 
292 292 292 292 292 292 292 292 292 292 333 373 373 373 373 373 373 334 292 292 292 292 333 373 373 373 373 373 373 334 292 292 292 292 292 292 292 292 292 292 
292 292 292 292 292 292 292 292 292 292 292 292 292 292 292 292 292 292 292 292 292 292 292 292 292 292 292 292 292 292 292 292 292 292 292 292 292 292 292 292 
2
3 23 10 1
8 20 11 200
