1 1 1 1 1 1 1 1 1 1 1 1 1 1 1 1 1 1 1 1 1 1 1 1 1 1 1 1 1 1 1 1 1 1 1 1 1 1 1 1 
9 9 9 9 9 9 9 9 9 1 1 1 1 1 9 9 9 9 9 9 9 9 9 9 9 9 1 1 1 1 1 9 9 9 9 9 9 9 9 9 
0 0 0 0 0 0 0 0 0 50 1 1 1 49 0 0 0 0 0 0 0 0 0 0 0 0 50 1 1 1 49 0 0 0 0 0 0 0 0 0 
0 0 0 0 0 0 0 0 0 50 1 1 1 49 0 0 0 0 0 0 0 0 0 0 0 0 50 1 1 1 49 0 0 0 0 0 0 0 0 0 
0 0 0 0 0 0 0 0 0 50 1 1 1 49 0 0 0 0 0 0 0 0 0 0 0 0 50 1 1 1 49 0 0 0 0 0 0 0 0 0 
0 0 0 0 0 0 0 0 0 50 1 1 1 49 0 0 0 0 0 0 0 0 0 0 0 0 50 1 1 1 49 0 0 0 0 0 0 0 0 0 
0 0 0 0 0 0 0 0 0 0 9 1 9 0 0 0 0 0 0 0 0 0 0 0 0 0 50 1 1 1 49 0 0 0 0 0 0 0 0 0 
0 0 0 0 0 0 0 0 0 0 0 9 0 0 0 0 0 0 0 0 0 0 0 0 0 0 50 1 1 1 49 0 0 0 0 0 0 0 0 0 
0 0 0 0 0 0 0 0 0 0 0 0 0 0 0 0 0 0 0 0 0 0 0 0 0 0 50 1 1 1 49 0 0 0 0 0 0 0 0 0 
0 0 0 0 0 0 0 0 0 0 0 0 0 0 0 0 0 0 0 0 0 0 0 0 0 0 50 1 1 1 49 0 0 0 0 0 0 0 0 0 
0 0 0 0 0 0 0 0 0 0 0 0 0 0 0 0 0 0 0 0 0 0 0 0 0 0 50 1 1 1 49 0 0 0 0 0 0 0 0 0 
0 0 0 0 0 0 0 0 0 0 0 0 0 0 0 0 0 0 0 0 0 0 0 0 0 0 50 1 1 1 49 0 0 0 0 0 0 0 0 0 
0 0 0 0 0 0 0 0 0 0 0 0 0 0 0 0 0 0 0 0 0 0 0 0 0 0 50 1 1 1 49 0 0 0 0 0 0 0 0 0 
0 0 0 0 0 0 0 0 0 0 0 0 0 0 0 0 0 0 0 0 0 0 0 0 0 0 50 1 1 1 49 0 0 0 0 0 0 0 0 0 
0 0 0 0 0 0 0 0 0 0 0 0 0 0 0 0 0 0 0 0 0 0 0 0 0 0 50 1 1 1 49 0 0 0 0 0 0 0 0 0 
0 0 0 0 0 0 0 0 0 0 0 0 0 0 0 0 0 0 0 0 0 0 0 0 0 0 50 1 1 1 49 0 0 0 0 0 0 0 0 0 
0 0 0 0 0 0 0 0 0 0 0 0 0 0 0 0 0 0 0 0 0 0 0 0 0 0 50 1 1 1 49 0 0 0 0 0 0 0 0 0 
0 0 0 0 0 0 0 0 0 0 0 0 0 0 0 0 0 0 0 0 0 0 0 0 0 0 50 1 1 1 49 0 0 0 0 0 0 0 0 0 
0 0 0 0 0 0 0 0 0 0 0 0 0 0 0 0 0 0 0 0 0 0 0 0 0 0 50 1 1 1 49 0 0 0 0 0 0 0 0 0 
0 0 0 0 0 0 0 0 0 0 0 0 0 0 0 0 0 0 0 0 0 0 0 0 0 0 50 1 1 1 49 0 0 0 0 0 0 0 0 0 
0 0 0 0 0 0 0 0 0 0 0 0 0 0 0 0 0 0 0 0 0 0 0 0 0 0 50 1 1 1 49 0 0 0 0 0 0 0 0 0 
0 0 0 0 0 0 0 0 0 0 0 0 0 0 0 0 0 0 0 0 0 0 0 0 0 0 50 1 1 1 49 0 0 0 0 0 0 0 0 0 
0 0 0 0 0 0 0 0 0 0 0 0 0 0 0 0 0 0 0 0 0 0 0 0 0 0 50 1 1 1 49 0 0 0 0 0 0 0 0 0 
0 0 0 0 0 0 0 0 0 0 0 0 0 0 0 0 0 0 0 0 0 0 0 0 0 0 50 1 1 1 49 0 0 0 0 0 0 0 0 0 
0 0 0 0 0 0 0 0 0 0 0 8 0 0 0 0 0 0 0 0 0 0 0 0 0 0 50 1 1 1 49 0 0 0 0 0 0 0 0 0 
0 0 0 0 0 0 0 0 0 0 8 1 8 0 0 0 0 0 0 0 0 0 0 0 0 0 50 1 1 1 49 0 0 0 0 0 0 0 0 0 
0 0 0 0 0 0 0 0 0 50 1 1 1 49 0 0 0 0 0 0 0 0 0 0 0 0 50 1 1 1 49 0 0 0 0 0 0 0 0 0 
0 0 0 0 0 0 0 0 0 50 1 1 1 49 0 0 0 0 0 0 0 0 0 0 0 0 50 1 1 1 49 0 0 0 0 0 0 0 0 0 
0 0 0 0 0 0 0 0 0 50 1 1 1 49 0 0 0 0 0 0 0 0 0 0 0 0 50 1 1 1 49 0 0 0 0 0 0 0 0 0 
3
0 3 11 72
14 3 11 96
31 3 11 80
