0 0 0 0 0 0 0 0 0 50 1 1 1 49 0 0 0 0 0 0 0 0 0 0 0 0 50 1 1 1 49 0 0 0 0 0 0 0 0 0 
0 0 0 0 0 0 0 0 0 50 1 1 1 49 0 0 0 0 0 0 0 0 0 0 0 0 50 1 1 1 49 0 0 0 0 0 0 0 0 0 
0 0 0 0 0 0 0 0 0 50 1 1 1 49 0 0 0 0 0 0 0 0 0 0 0 0 50 1 1 1 49 0 0 0 0 0 0 0 0 0 
0 0 0 0 0 0 0 0 0 50 1 1 1 49 0 0 0 0 0 0 0 0 0 0 0 0 0 7 1 7 0 0 0 0 0 0 0 0 0 0 
0 0 0 0 0 0 0 0 0 50 1 1 1 49 0 0 0 0 0 0 0 0 0 0 0 0 0 0 7 0 0 0 0 0 0 0 0 0 0 0 
0 0 0 0 0 0 0 0 0 50 1 1 1 49 0 0 0 0 0 0 0 0 0 0 0 0 0 0 0 0 0 0 0 0 0 0 0 0 0 0 
0 0 0 0 0 0 0 0 0 50 1 1 1 49 0 0 0 0 0 0 0 0 0 0 0 0 0 0 0 0 0 0 0 0 0 0 0 0 0 0 
0 0 0 0 0 0 0 0 0 50 1 1 1 49 0 0 0 0 0 0 0 0 0 0 0 0 0 0 0 0 0 0 0 0 0 0 0 0 0 0 
0 0 0 0 0 0 0 0 0 50 1 1 1 49 0 0 0 0 0 0 0 0 0 0 0 0 0 0 0 0 0 0 0 0 0 0 0 0 0 0 
0 0 0 0 0 0 0 0 0 50 1 1 1 49 0 0 0 0 0 0 0 0 0 0 0 0 0 0 0 0 0 0 0 0 0 0 0 0 0 0 
0 0 0 0 0 0 0 0 0 50 1 1 1 49 0 0 0 0 0 0 0 0 0 0 0 0 0 0 0 0 0 0 0 0 0 0 0 0 0 0 
0 0 0 0 0 0 0 0 0 50 1 1 1 49 0 0 0 0 0 0 0 0 0 0 0 0 0 0 0 0 0 0 0 0 0 0 0 0 0 0 
0 0 0 0 0 0 0 0 0 50 1 1 1 49 0 0 0 0 0 0 0 0 0 0 0 0 0 0 0 0 0 0 0 0 0 0 0 0 0 0 
0 0 0 0 0 0 0 0 0 50 1 1 1 49 0 0 0 0 0 0 0 0 0 0 0 0 0 0 0 0 0 0 0 0 0 0 0 0 0 0 
0 0 0 0 0 0 0 0 0 50 1 1 1 49 0 0 0 0 0 0 0 0 0 0 0 0 0 0 0 0 0 0 0 0 0 0 0 0 0 0 
0 0 0 0 0 0 0 0 0 50 1 1 1 49 0 0 0 0 0 0 0 0 0 0 0 0 0 0 0 0 0 0 0 0 0 0 0 0 0 0 
0 0 0 0 0 0 0 0 0 50 1 1 1 49 0 0 0 0 0 0 0 0 0 0 0 0 0 0 0 0 0 0 0 0 0 0 0 0 0 0 
0 0 0 0 0 0 0 0 0 50 1 1 1 49 0 0 0 0 0 0 0 0 0 0 0 0 0 0 0 0 0 0 0 0 0 0 0 0 0 0 
0 0 0 0 0 0 0 0 0 50 1 1 1 49 0 0 0 0 0 0 0 0 0 0 0 0 0 0 8 0 0 0 0 0 0 0 0 0 0 0 
0 0 0 0 0 0 0 0 0 50 1 1 1 49 0 0 0 0 0 0 0 0 0 0 0 0 0 8 1 8 0 0 0 0 0 0 0 0 0 0 
0 0 0 0 0 0 0 0 0 50 1 1 1 49 0 0 0 0 0 0 0 0 0 0 0 0 50 1 1 1 49 0 0 0 0 0 0 0 0 0 
0 0 0 0 0 0 0 0 0 50 1 1 1 49 0 0 0 0 0 0 0 0 0 0 0 0 50 1 1 1 49 0 0 0 0 0 0 0 0 0 
0 0 0 0 0 0 0 0 0 50 1 1 1 49 0 0 0 0 0 0 0 0 0 0 0 0 50 1 1 1 49 0 0 0 0 0 0 0 0 0 
0 0 0 0 0 0 0 0 0 50 1 1 1 49 0 0 0 0 0 0 0 0 0 0 0 0 50 1 1 1 49 0 0 0 0 0 0 0 0 0 
0 0 0 0 0 0 0 0 0 50 1 1 1 49 0 0 0 0 0 0 0 0 0 0 0 0 50 1 1 1 49 0 0 0 0 0 0 0 0 0 
8 8 8 8 8 8 8 8 8 1 1 1 1 1 8 8 8 8 8 8 8 8 8 8 8 8 1 1 1 1 1 8 8 8 8 8 8 8 8 8 
1 1 1 1 1 1 1 1 1 1 1 1 1 1 1 1 1 1 1 1 1 1 1 1 1 1 1 1 1 1 1 1 1 1 1 1 1 1 1 1 
1 1 1 1 1 1 1 1 1 1 1 1 1 1 1 1 1 1 1 1 1 1 1 1 1 1 1 1 1 1 1 1 1 1 1 1 1 1 1 1 
1 1 1 1 1 1 1 1 1 1 1 1 1 1 1 1 1 1 1 1 1 1 1 1 1 1 1 1 1 1 1 1 1 1 1 1 1 1 1 1 
3
0 22 11 72
14 22 11 96
31 22 11 80
