1 1 1 1 1 1 1 1 1 1 1 1 1 1 1 1 1 1 49 0 0 0 0 0 0 0 50 1 1 1 0 0 0 0 0 0 1 1 1 1 
1 1 1 1 1 1 1 1 1 1 9 9 9 9 9 9 9 9 0 0 0 0 0 0 0 0 50 1 1 1 0 0 0 0 0 0 1 1 1 1 
1 1 1 1 1 1 1 1 1 49 0 0 0 0 0 0 0 0 0 0 0 0 0 0 0 0 50 1 1 1 0 0 0 0 0 0 1 1 1 1 
1 1 1 1 1 1 1 1 1 49 0 0 0 0 0 0 0 0 0 0 0 0 0 0 0 0 50 1 1 1 0 0 0 0 0 0 1 1 1 1 
1 1 1 1 1 1 1 1 1 49 0 0 0 0 0 0 0 0 0 0 0 0 0 0 0 0 50 1 1 1 0 0 0 0 0 0 1 1 1 1 
1 1 1 1 1 1 1 1 1 49 0 0 0 0 0 0 0 0 0 0 0 0 0 0 0 0 50 1 1 1 0 0 0 0 0 0 1 1 1 1 
1 1 1 1 1 1 1 1 1 49 0 0 0 0 0 0 0 0 0 0 0 0 0 0 0 0 50 1 1 1 0 0 0 0 0 0 1 1 1 1 
1 1 1 1 1 1 1 1 1 49 0 0 0 0 0 0 0 0 0 0 0 0 0 0 0 0 50 1 1 1 0 0 0 1 1 1 1 1 1 1 
1 1 1 1 1 1 1 1 1 49 0 0 0 0 0 0 0 0 0 0 0 0 0 0 0 0 50 1 1 1 0 0 0 1 1 1 1 1 1 1 
1 1 1 1 1 1 1 1 1 49 0 0 0 0 0 0 0 0 0 0 0 0 0 0 0 0 50 1 1 1 0 0 0 0 0 0 0 0 1 1 
1 1 1 1 1 1 1 1 1 49 0 0 0 0 0 0 0 0 0 0 0 0 0 0 0 0 50 1 1 1 0 0 0 0 0 0 0 0 1 1 
1 1 1 1 1 1 1 1 1 49 0 0 0 0 0 0 0 8 0 0 0 0 0 0 0 0 50 1 1 1 0 0 0 0 0 0 0 0 1 1 
1 1 1 1 1 1 1 1 1 49 0 0 0 0 0 0 50 1 49 0 0 0 0 0 0 0 50 1 1 1 0 0 0 0 0 0 0 0 1 1 
1 1 1 1 1 1 1 1 1 49 0 0 0 0 0 0 50 1 49 0 0 0 0 0 0 0 50 1 1 1 0 0 0 0 0 0 0 0 1 1 
1 1 1 1 1 1 1 1 1 49 0 0 0 0 0 0 50 1 49 0 0 0 0 0 0 0 50 1 1 1 1 1 1 1 1 0 0 0 1 1 
1 1 1 1 1 1 1 1 1 49 0 0 0 0 0 0 50 1 49 0 0 0 0 0 0 0 50 1 1 1 0 0 0 0 0 0 0 0 1 1 
1 1 1 1 1 1 1 1 1 49 0 0 0 0 0 0 50 1 49 0 0 0 0 0 0 0 50 1 1 1 0 0 0 0 0 0 0 0 1 1 
1 1 1 1 1 1 1 1 1 49 0 0 0 0 0 0 0 9 0 0 0 0 0 0 0 0 50 1 1 1 0 0 0 0 0 0 0 0 1 1 
1 1 1 1 1 1 1 1 1 49 0 0 0 0 0 0 0 0 0 0 0 0 0 0 0 0 50 1 1 1 0 0 0 0 0 0 0 0 1 1 
1 1 1 1 1 1 1 1 1 49 0 0 0 0 0 0 0 0 0 0 0 0 0 0 0 0 50 1 1 1 0 0 0 0 0 0 0 0 1 1 
1 1 1 1 1 1 1 1 1 49 0 0 0 0 0 0 0 0 0 0 0 0 0 0 0 0 50 1 1 1 0 0 0 1 1 1 1 1 1 1 
1 1 1 1 1 1 1 1 1 49 0 0 0 0 0 0 0 0 0 0 0 0 0 0 0 0 50 1 1 1 0 0 0 1 1 1 1 1 1 1 
1 1 1 1 1 1 1 1 1 49 0 0 0 0 0 0 0 0 0 0 0 0 0 0 0 0 50 1 1 1 0 0 0 0 0 0 1 1 1 1 
1 1 1 1 1 1 1 1 1 49 0 0 0 0 0 0 0 0 0 0 0 0 0 0 0 0 50 1 1 1 0 0 0 0 0 0 1 1 1 1 
1 1 1 1 1 1 1 1 1 49 0 0 0 0 0 0 0 0 0 0 0 0 0 0 0 0 50 1 1 1 0 0 0 0 0 0 1 1 1 1 
1 1 1 1 1 1 1 1 1 49 0 0 0 0 0 0 0 0 0 0 0 0 0 0 0 0 50 1 1 1 0 0 0 0 0 0 1 1 1 1 
1 1 1 1 1 1 1 1 1 49 0 0 0 0 0 0 0 0 0 0 0 0 0 0 0 0 50 1 1 1 0 0 0 0 0 0 1 1 1 1 
1 1 1 1 1 1 1 1 1 1 8 8 8 8 8 8 8 8 0 0 0 0 0 0 0 0 50 1 1 1 0 0 0 0 0 0 1 1 1 1 
1 1 1 1 1 1 1 1 1 1 1 1 1 1 1 1 1 1 49 0 0 0 0 0 0 0 50 1 1 1 0 0 0 0 0 0 1 1 1 1 
4
34 18 10 1
19 14 11 56
17 2 12 72
17 18 12 72
