219 218 98 220 218 98 98 98 98 98 98 98 98 98 98 98 98 98 98 98 98 98 98 98 98 98 98 98 98 98 98 98 98 98 98 98 98 98 98 98 
219 218 98 220 258 259 259 259 259 259 259 259 259 259 259 259 259 259 259 259 259 259 259 259 259 259 259 259 259 259 259 259 259 259 259 259 259 259 259 259 
219 218 98 220 0 0 0 0 0 0 0 0 0 0 0 0 0 0 0 0 0 0 0 0 0 0 0 0 0 0 0 0 0 0 0 0 0 0 0 0 
179 140 98 220 0 0 0 0 0 0 0 0 0 0 0 0 0 0 0 0 0 0 0 0 0 0 0 0 0 0 0 0 0 0 0 0 0 0 0 0 
98 98 98 220 0 0 0 0 0 0 0 0 0 0 0 0 0 0 0 0 0 0 0 0 0 0 0 0 0 0 0 0 0 0 0 0 0 0 0 0 
259 259 259 260 0 0 0 0 0 0 0 0 0 0 0 0 0 0 0 0 0 0 0 0 0 0 0 0 0 0 0 0 0 0 0 0 0 0 0 0 
7 7 7 7 0 0 0 0 0 0 0 0 0 0 0 0 0 0 0 0 0 0 0 0 0 0 0 0 0 0 0 0 0 0 0 0 0 0 0 0 
0 0 0 0 0 0 0 0 0 0 0 0 0 0 0 0 0 0 0 0 0 0 0 0 0 0 0 0 0 0 0 0 0 0 0 0 0 0 0 0 
0 0 0 0 0 0 0 0 0 0 0 0 178 179 179 180 0 0 0 0 178 179 179 180 0 0 0 0 178 179 179 180 0 0 0 0 178 179 179 179 
0 0 0 0 0 0 0 0 6 6 6 6 218 98 98 220 6 6 6 6 218 98 98 220 6 6 6 6 218 98 98 220 6 6 6 6 218 98 98 98 
0 0 0 0 0 0 0 0 178 179 179 180 218 98 98 220 178 179 179 180 218 98 98 220 178 179 179 180 218 98 98 220 178 179 179 180 218 98 99 259 
0 0 0 0 0 0 0 0 218 98 98 220 218 98 98 220 218 98 98 220 218 98 98 220 218 98 98 220 218 98 98 220 218 98 98 220 218 98 220 219 
0 0 0 0 0 0 0 0 218 98 98 220 218 98 98 220 218 98 98 220 218 98 98 220 218 98 98 220 218 98 98 220 218 98 98 220 218 98 220 219 
0 0 0 0 0 0 0 0 218 98 98 220 258 259 259 260 218 98 98 220 258 259 259 260 218 98 98 220 258 259 259 260 218 98 98 220 218 98 220 219 
179 179 179 179 179 179 179 180 218 98 98 220 0 0 0 0 218 98 98 220 0 0 0 0 218 98 98 220 0 0 0 0 218 98 98 220 218 98 220 219 
98 98 98 98 98 98 98 220 218 98 98 220 0 0 0 0 218 98 98 220 0 0 0 0 218 98 98 220 0 0 0 0 218 98 98 220 218 98 220 219 
98 98 98 98 98 98 98 220 218 98 98 220 0 0 0 0 218 98 98 220 0 0 0 0 218 98 98 220 0 0 0 0 218 98 98 220 218 98 139 179 
98 98 98 98 98 98 98 220 218 98 98 220 0 0 0 0 218 98 98 220 0 0 0 0 218 98 98 220 0 0 0 0 218 98 98 220 218 98 98 98 
259 259 259 259 259 259 259 260 218 98 98 220 0 0 0 0 218 98 98 220 0 0 0 0 218 98 98 220 0 0 0 0 218 98 98 220 258 259 259 259 
0 0 0 0 0 0 0 0 218 98 98 220 0 0 0 0 218 98 98 220 0 0 0 0 218 98 98 220 0 0 0 0 218 98 98 220 0 0 0 0 
0 0 0 0 0 0 0 0 258 259 259 260 0 0 0 0 258 259 259 260 0 0 0 0 258 259 259 260 0 0 0 0 258 259 259 260 0 0 0 0 
0 0 0 0 0 0 0 0 0 0 0 0 0 0 0 0 0 0 0 0 0 0 0 0 0 0 0 0 0 0 0 0 0 0 0 0 0 0 0 0 
0 0 0 0 0 0 0 0 0 0 0 0 0 0 0 0 0 0 0 0 0 0 0 0 0 0 0 0 0 0 0 0 0 0 0 0 0 0 0 0 
0 0 0 0 0 0 0 0 0 0 0 0 0 0 0 0 0 0 0 0 0 0 0 0 0 0 0 0 0 0 0 0 0 0 0 0 0 0 0 0 
0 0 0 0 0 0 0 0 0 0 0 0 0 0 0 0 0 0 0 0 0 0 0 0 0 0 0 0 0 0 0 0 0 0 0 0 0 0 0 0 
179 179 179 179 179 179 179 179 179 179 179 179 179 179 179 179 179 179 179 179 179 179 179 179 179 179 179 179 179 179 179 179 179 179 179 179 179 179 179 179 
98 98 98 98 98 98 98 98 98 98 98 98 98 98 98 98 98 98 98 98 98 98 98 98 98 98 98 98 98 98 98 98 98 98 98 98 98 98 98 98 
259 259 259 259 259 259 259 259 259 259 259 259 259 259 259 259 259 259 259 259 259 259 259 259 259 259 259 259 259 259 259 259 259 259 259 259 259 259 259 259 
219 219 219 219 219 219 219 219 219 219 219 219 219 219 219 219 219 219 219 219 219 219 219 219 219 219 219 219 219 219 219 219 219 219 219 219 219 219 219 219 
3
13 15 1 0 3 0 0 320 240
21 22 1 1 3 0 0 320 240
29 15 1 0 3 0 0 320 240
