101 101 101 101 101 101 101 101 101 101 101 101 101 101 101 101 101 101 101 101 101 101 101 101 101 101 101 101 101 101 101 101 101 101 101 101 101 101 101 101 
101 101 101 101 101 101 101 101 101 101 101 101 101 101 101 101 101 101 101 101 101 101 101 101 101 101 101 101 101 101 101 101 101 101 101 101 101 101 101 101 
101 101 101 101 101 101 101 101 101 101 101 101 101 101 101 101 101 101 101 101 101 101 101 101 101 101 101 101 101 101 101 101 101 101 101 101 101 101 101 101 
101 101 101 101 101 101 101 101 101 101 101 101 101 101 101 101 101 101 101 101 101 101 101 101 101 101 101 101 101 101 101 101 101 101 101 101 101 101 101 101 
262 262 262 262 262 262 262 103 101 101 101 101 101 102 262 262 262 262 262 262 262 262 262 262 262 262 262 262 262 262 262 262 262 262 262 262 262 262 262 262 
738 738 738 738 738 738 738 221 101 101 101 101 101 223 738 738 738 738 738 738 738 738 738 738 738 738 738 738 738 738 738 738 738 738 738 738 738 738 738 738 
738 738 738 738 738 738 738 221 101 101 101 101 101 223 738 738 738 738 738 738 738 738 738 738 738 738 738 738 738 738 738 738 738 738 738 738 738 738 738 738 
738 738 738 738 738 738 738 221 101 101 101 101 101 223 738 738 738 738 738 738 738 738 738 738 738 738 738 738 738 738 738 738 738 738 738 738 738 738 738 738 
738 738 738 738 738 738 738 221 101 101 101 101 101 223 738 738 738 738 738 738 738 738 738 738 738 738 738 738 738 738 738 738 738 738 738 738 738 738 738 738 
738 738 738 738 738 738 738 221 101 101 101 101 101 223 738 738 738 738 738 738 738 738 738 738 738 738 738 738 738 738 738 738 738 738 738 738 738 738 738 738 
738 738 738 738 738 738 738 221 101 101 101 101 101 223 738 738 738 738 738 738 738 738 738 738 738 738 738 738 738 738 738 738 738 738 738 738 738 738 738 738 
738 738 738 738 738 738 738 221 101 101 101 101 101 223 738 738 738 738 738 738 738 738 738 738 738 738 738 738 738 738 738 738 738 738 738 738 738 738 738 738 
738 738 738 738 738 738 738 221 101 101 101 101 101 142 182 182 182 182 182 182 182 182 182 182 182 182 182 182 182 182 182 182 183 738 738 738 738 738 738 738 
738 738 738 738 738 738 738 221 101 101 101 101 101 101 101 101 101 101 101 101 101 101 101 101 101 101 101 101 101 101 101 101 223 738 738 738 738 738 738 738 
738 738 738 738 738 738 738 221 101 101 101 101 101 101 101 101 101 101 101 101 101 101 101 101 101 101 101 101 101 101 101 101 223 738 738 738 738 738 738 738 
738 738 738 738 738 738 738 261 262 262 262 262 262 262 262 262 262 262 262 262 262 262 262 262 262 262 262 262 262 262 262 262 263 738 738 738 738 738 738 738 
738 738 738 738 738 738 738 738 738 738 738 738 738 738 738 738 738 738 738 738 738 738 738 738 738 738 738 738 738 738 738 738 738 738 738 738 738 738 738 738 
738 738 738 738 738 738 738 738 738 738 738 738 738 738 738 738 738 738 738 738 738 738 738 738 738 738 738 738 738 738 738 738 738 738 738 738 738 738 738 738 
738 738 738 738 738 738 738 738 738 738 738 738 738 738 738 738 738 738 738 738 738 738 738 738 738 738 738 738 738 738 738 738 738 738 738 738 738 738 738 738 
738 738 738 738 738 738 738 738 738 738 738 738 738 738 738 738 738 738 738 738 738 738 738 738 738 738 738 738 738 738 738 738 738 738 738 738 738 738 738 738 
738 738 738 738 738 738 738 738 738 738 738 738 738 738 738 738 738 738 738 738 738 738 738 738 738 738 738 738 738 738 738 738 738 738 738 738 738 738 738 738 
738 738 738 738 738 738 738 738 738 738 738 738 738 738 738 738 738 738 738 738 738 738 738 738 738 738 738 738 738 738 738 738 738 738 738 738 738 738 738 738 
738 738 738 738 738 738 738 738 738 738 738 738 738 738 738 738 738 738 738 738 738 738 738 738 738 738 738 738 738 738 738 738 738 738 738 738 738 738 738 738 
738 738 738 738 738 738 738 738 738 738 738 738 738 738 738 738 738 738 738 738 738 738 738 738 738 738 738 738 738 738 738 738 738 738 738 738 738 738 738 738 
738 738 738 738 738 738 738 738 738 738 738 738 738 738 738 738 738 738 738 738 738 738 738 738 738 738 738 738 738 738 738 738 738 738 738 738 738 738 738 738 
182 182 182 182 182 182 182 182 182 182 182 182 182 182 182 182 183 738 738 738 738 738 738 181 182 182 182 182 182 182 182 182 182 182 182 182 182 182 182 182 
101 101 101 101 101 101 101 101 101 101 101 101 101 101 101 101 223 738 738 738 738 738 738 221 101 101 101 101 101 101 101 101 101 101 101 101 101 101 101 101 
101 101 101 101 101 101 101 101 101 101 101 101 101 101 101 101 223 738 738 738 738 738 738 221 101 101 101 101 101 101 101 101 101 101 101 101 101 101 101 101 
101 101 101 101 101 101 101 101 101 101 101 101 101 101 101 101 223 738 738 738 738 738 738 221 101 101 101 101 101 101 101 101 101 101 101 101 101 101 101 101 
101 101 101 101 101 101 101 101 101 101 101 101 101 101 101 101 223 738 738 738 738 738 738 221 101 101 101 101 101 101 101 101 101 101 101 101 101 101 101 101 
0
