107 107 107 107 107 107 107 107 108 268 268 109 108 268 268 109 108 268 268 109 108 268 268 268 109 108 268 268 268 268 109 107 108 268 268 268 109 107 107 107 
268 268 268 268 268 268 268 268 269 572 574 227 229 572 574 267 269 572 574 267 269 572 573 574 227 229 572 573 573 574 267 268 269 572 573 574 267 268 268 268 
573 573 573 573 573 573 573 573 573 534 614 227 229 612 533 573 573 534 533 573 573 534 492 614 227 229 612 492 492 533 573 573 573 534 492 614 0 0 0 0 
492 492 492 492 492 492 492 492 492 492 614 227 229 612 492 492 492 492 492 492 492 493 653 654 227 229 612 492 492 492 492 492 492 492 492 614 0 0 0 0 
492 492 492 492 492 492 492 492 492 492 614 227 229 612 492 492 492 492 492 492 492 614 187 188 149 269 612 492 492 492 492 492 492 492 493 654 0 0 0 0 
492 492 492 492 492 492 492 492 492 492 614 267 269 612 492 492 492 492 492 492 492 614 267 268 269 572 534 492 492 492 492 492 493 653 654 0 0 0 0 0 
492 492 492 492 492 492 492 492 492 492 533 573 573 534 492 492 492 492 492 492 492 533 573 573 573 534 492 492 492 492 492 493 654 0 0 0 0 0 0 0 
492 492 492 492 492 492 492 492 492 492 492 492 492 492 492 492 492 492 492 492 492 492 492 492 492 492 493 653 653 653 653 654 0 0 0 0 0 0 0 0 
492 492 492 492 492 492 492 492 492 492 492 492 492 492 492 492 492 492 492 492 492 492 492 492 493 653 654 0 0 692 0 0 0 0 0 0 0 0 0 0 
492 492 492 492 492 492 492 492 492 492 492 492 492 492 492 492 492 492 492 492 492 493 653 653 654 0 0 0 0 692 0 0 0 0 0 0 0 0 0 0 
653 653 653 653 653 653 653 653 653 653 653 653 653 653 653 653 653 653 653 653 653 654 0 0 0 0 0 0 0 692 0 0 0 0 0 0 0 0 0 0 
0 0 0 0 0 0 0 0 0 692 0 0 0 0 0 0 0 0 0 0 0 0 0 0 0 0 0 0 0 692 0 0 0 0 0 0 0 0 0 0 
0 0 0 0 0 0 0 0 0 692 0 0 0 0 0 0 0 0 0 0 0 0 0 0 0 0 0 0 0 692 0 0 0 0 0 0 0 0 0 0 
0 0 0 0 0 0 0 0 0 692 0 0 0 0 0 0 0 0 0 0 0 0 0 0 0 0 0 0 0 692 0 0 0 0 0 0 0 0 0 0 
0 0 0 0 0 0 0 0 0 692 0 0 0 0 0 0 0 0 0 0 0 0 0 0 0 0 0 0 0 692 0 0 0 0 0 0 0 0 0 0 
0 0 0 0 0 0 0 0 0 692 0 0 0 0 0 0 0 0 0 0 0 0 0 0 0 0 0 0 0 692 0 0 0 0 0 0 0 0 0 0 
0 0 0 0 0 0 0 0 0 692 0 0 0 0 0 0 0 0 0 0 0 0 0 0 0 0 0 0 0 692 0 0 0 0 0 0 0 0 0 0 
0 0 0 0 0 0 0 0 0 692 0 0 0 0 0 0 0 0 0 0 0 0 0 0 0 0 0 0 0 692 0 0 0 0 0 0 0 0 0 0 
0 0 0 0 0 0 0 0 0 692 0 0 0 0 0 0 0 0 0 0 0 0 0 0 0 0 0 0 0 692 0 0 0 0 0 0 0 0 0 0 
0 0 0 0 0 0 0 0 0 692 0 0 0 0 0 0 0 0 0 0 0 0 0 0 0 0 0 0 0 692 0 0 0 0 0 0 0 0 0 0 
0 0 0 0 0 0 0 0 0 692 0 0 0 0 0 0 0 0 0 0 0 0 0 0 0 0 0 0 0 692 0 0 0 0 0 0 0 0 0 0 
0 0 0 0 0 0 0 0 0 692 0 0 0 0 0 0 0 0 0 0 0 0 572 573 573 573 573 573 573 573 573 573 574 0 0 0 0 0 0 0 
0 0 0 0 0 572 573 573 573 573 573 573 573 573 573 573 573 573 573 573 573 573 534 492 492 492 492 492 492 492 492 492 614 0 0 0 0 0 0 0 
0 0 0 0 0 612 492 492 492 492 492 492 492 492 492 492 492 492 492 492 492 492 492 492 492 492 492 492 492 492 492 492 614 693 693 693 693 693 693 693 
0 0 0 0 0 652 653 653 653 653 494 492 492 492 492 492 492 492 492 492 492 492 492 492 492 492 492 492 493 653 653 653 654 0 0 0 0 0 0 0 
0 0 0 0 0 0 692 0 0 0 652 653 653 653 653 653 653 653 653 653 653 653 653 653 653 653 653 653 654 0 0 0 0 0 0 0 0 0 0 0 
0 0 0 0 0 0 692 0 0 0 0 0 0 0 0 0 0 0 0 0 0 0 0 0 0 0 0 0 0 0 0 0 0 0 0 0 0 0 0 0 
0 0 0 0 0 0 692 0 0 0 0 0 0 0 0 0 0 0 0 0 0 0 0 0 0 0 0 0 0 0 0 0 0 0 0 0 0 0 0 0 
0 0 0 0 0 0 692 0 0 0 0 0 0 0 0 0 0 0 0 0 0 0 0 0 0 0 0 0 0 0 0 0 0 0 0 0 0 0 0 0 
0 0 0 0 0 0 692 0 0 0 0 0 0 0 0 0 0 0 0 0 0 0 0 0 0 0 0 0 0 0 0 0 0 0 0 0 0 0 0 0 
1
16 20 10 1
