110 110 110 110 110 110 110 110 110 110 110 110 110 110 110 110 110 110 110 110 110 110 110 110 110 110 110 110 110 110 110 110 110 110 110 110 110 110 110 110 
110 110 110 110 110 110 110 110 110 110 110 110 110 110 110 110 110 110 110 110 110 110 110 110 110 110 110 110 110 110 110 110 110 110 110 110 110 110 110 110 
110 110 110 110 110 110 110 110 110 110 110 110 110 110 110 110 110 110 110 110 110 110 110 110 110 110 110 110 110 110 110 110 110 110 110 110 110 110 110 110 
110 110 110 110 110 110 110 110 110 110 110 110 110 110 110 110 110 110 110 110 110 110 110 110 110 110 110 110 110 110 110 110 110 110 110 110 110 110 110 110 
271 271 271 271 271 271 271 271 112 110 110 110 110 110 110 110 110 110 110 110 110 110 110 110 110 110 110 110 110 110 110 110 110 110 110 110 110 110 110 110 
747 747 747 747 747 747 747 747 270 271 271 112 110 110 110 110 110 110 110 110 110 110 110 110 110 110 110 110 110 110 110 110 110 110 110 110 110 110 110 110 
747 747 747 747 747 747 747 747 747 747 747 270 271 271 112 110 110 110 110 110 110 110 110 110 110 110 110 110 110 110 110 110 110 110 110 110 110 110 110 110 
747 747 747 747 747 747 747 747 747 747 747 747 747 747 270 271 271 271 271 271 271 271 271 271 271 271 271 271 271 271 271 271 271 271 271 271 112 110 110 110 
747 747 747 747 747 747 747 747 747 747 747 747 747 747 747 747 747 747 747 747 747 747 747 747 747 747 747 747 747 747 747 747 747 747 747 747 230 110 110 110 
747 747 747 747 747 747 747 747 747 747 747 747 747 747 747 747 747 747 747 747 747 747 747 747 747 747 747 747 747 747 747 747 747 747 747 747 270 112 110 110 
747 748 908 908 749 748 908 908 749 748 908 908 749 748 908 908 749 748 908 908 749 748 908 908 749 747 747 747 747 747 747 747 747 747 747 747 747 230 110 110 
747 869 0 0 867 869 0 0 867 869 0 0 867 869 0 0 867 869 0 0 867 869 0 0 867 747 747 747 747 747 747 747 747 747 747 747 747 230 110 110 
747 869 0 0 867 869 0 0 867 869 0 0 867 869 0 0 867 869 0 0 867 869 0 0 867 747 747 747 747 747 747 747 747 747 747 747 747 230 110 110 
747 869 0 0 867 869 0 0 867 869 0 0 867 869 0 0 867 869 0 0 867 869 0 0 867 747 747 747 747 747 747 747 747 747 747 747 747 230 110 110 
747 869 0 0 867 869 0 0 867 869 0 0 867 869 0 0 867 869 0 0 867 869 0 0 867 747 747 747 747 747 747 747 747 747 747 747 747 230 110 110 
747 869 0 0 867 869 0 0 867 869 0 0 867 869 0 0 867 869 0 0 867 869 0 0 867 747 747 747 747 747 747 747 747 747 747 747 190 152 110 110 
747 869 0 0 867 869 0 0 867 869 0 0 867 869 0 0 867 869 0 0 867 869 0 0 867 747 747 747 747 747 747 747 747 747 747 747 230 110 110 110 
747 869 0 0 867 869 0 0 867 869 0 0 867 869 0 0 867 869 0 0 867 788 828 828 789 747 747 747 747 190 191 191 191 191 191 191 152 110 110 110 
747 869 0 0 867 869 0 0 867 869 0 0 867 869 0 0 867 869 0 0 867 747 747 747 747 747 747 747 190 152 110 110 110 110 110 110 110 110 110 110 
747 869 0 0 867 869 0 0 867 869 0 0 867 869 0 0 867 869 0 0 867 747 747 747 747 747 747 190 152 110 110 110 110 110 110 110 110 110 110 110 
747 788 828 828 789 788 828 828 789 788 828 828 789 788 828 828 789 788 828 828 789 747 747 747 747 747 190 152 110 110 110 110 110 110 110 110 110 110 110 110 
747 747 747 747 747 747 747 747 747 747 747 747 747 747 747 747 747 747 747 747 747 747 747 747 747 190 152 110 110 110 110 110 110 110 110 110 110 110 110 110 
747 747 747 747 747 747 747 747 747 747 747 747 747 747 747 747 747 747 747 747 747 747 747 747 190 152 110 110 110 110 110 110 110 110 110 110 110 110 110 110 
747 747 747 747 747 747 747 747 747 747 747 747 747 747 747 747 747 747 747 747 747 747 747 190 152 110 110 110 110 110 110 110 110 110 110 110 110 110 110 110 
747 747 747 747 747 747 747 747 747 747 747 747 747 747 747 747 747 747 747 747 747 747 190 152 110 110 110 110 110 110 110 110 110 110 110 110 110 110 110 110 
191 191 191 191 191 191 191 191 191 191 191 191 191 191 191 191 191 191 191 191 191 191 152 110 110 110 110 110 110 110 110 110 110 110 110 110 110 110 110 110 
110 110 110 110 110 110 110 110 110 110 110 110 110 110 110 110 110 110 110 110 110 110 110 110 110 110 110 110 110 110 110 110 110 110 110 110 110 110 110 110 
110 110 110 110 110 110 110 110 110 110 110 110 110 110 110 110 110 110 110 110 110 110 110 110 110 110 110 110 110 110 110 110 110 110 110 110 110 110 110 110 
110 110 110 110 110 110 110 110 110 110 110 110 110 110 110 110 110 110 110 110 110 110 110 110 110 110 110 110 110 110 110 110 110 110 110 110 110 110 110 110 
110 110 110 110 110 110 110 110 110 110 110 110 110 110 110 110 110 110 110 110 110 110 110 110 110 110 110 110 110 110 110 110 110 110 110 110 110 110 110 110 
0
