116 116 116 116 116 116 116 116 116 116 116 116 116 116 116 116 116 116 116 116 116 116 116 116 116 116 116 116 116 116 116 116 116 116 116 116 116 116 116 116 
116 116 116 116 116 116 116 116 116 116 116 116 116 116 116 116 116 116 116 116 116 116 116 116 116 116 116 116 116 116 116 116 116 116 116 116 116 116 116 116 
116 116 116 116 116 116 116 116 116 116 116 116 116 116 116 116 116 116 116 116 116 116 116 116 116 116 116 116 116 116 116 116 116 116 116 116 116 116 116 116 
116 116 116 116 116 116 116 116 116 116 116 116 116 116 116 116 116 116 116 116 116 116 116 116 116 116 116 116 116 116 116 116 116 116 116 116 116 116 116 116 
116 116 116 116 116 116 116 116 116 116 116 116 116 116 116 116 116 116 116 116 116 116 116 116 116 116 116 116 116 116 116 116 116 116 116 116 116 116 116 116 
277 277 277 277 277 118 116 116 116 116 116 116 116 116 116 116 116 116 116 116 116 116 116 116 116 116 116 116 116 116 116 116 116 116 116 116 116 116 116 116 
753 753 753 753 753 236 116 116 116 116 116 116 116 116 116 116 116 116 116 116 116 116 116 116 116 116 116 116 116 116 116 116 116 116 116 116 116 116 116 116 
753 753 753 753 753 276 277 277 277 277 277 277 277 277 277 277 277 277 277 277 277 277 277 277 277 277 277 277 118 116 116 116 116 116 116 116 116 116 116 116 
753 753 753 753 753 753 753 753 753 753 753 753 753 753 753 753 753 753 753 753 753 753 753 753 753 753 753 753 236 116 116 116 116 116 116 116 116 116 116 116 
753 753 753 753 753 753 753 753 753 753 753 753 753 753 753 753 753 753 753 753 753 753 753 753 753 753 753 753 236 116 116 116 116 116 116 116 116 116 116 116 
753 753 753 753 754 914 914 914 914 755 753 753 754 914 914 914 914 755 753 753 754 914 914 914 914 755 753 753 236 116 116 116 116 116 116 116 116 116 116 116 
753 753 753 753 875 0 0 0 0 873 753 753 875 0 0 0 0 873 753 753 875 0 0 0 0 873 753 753 236 116 116 116 116 116 116 116 116 116 116 116 
753 753 753 753 875 0 0 0 0 873 753 753 875 0 0 0 0 873 753 753 875 0 0 0 0 873 753 753 236 116 116 116 116 116 116 116 116 116 116 116 
753 753 753 753 875 0 0 0 0 873 753 753 875 0 0 0 0 873 753 753 875 0 0 0 0 873 753 753 236 116 116 116 116 116 116 116 116 116 116 116 
753 753 753 753 875 0 0 0 0 873 753 753 875 0 0 0 0 873 753 753 875 0 0 0 0 873 753 753 236 116 116 116 116 116 116 116 116 116 116 116 
753 753 753 753 875 0 0 0 0 873 753 753 794 834 834 834 834 795 753 753 875 0 0 0 0 873 753 753 236 116 116 116 116 116 116 116 116 116 116 116 
753 753 753 753 875 0 0 0 0 873 753 753 753 753 753 753 753 753 753 753 875 0 0 0 0 873 753 753 236 116 116 116 116 116 116 116 116 116 116 116 
753 753 753 753 875 0 0 0 0 873 753 753 753 753 753 753 753 753 753 753 875 0 0 0 0 873 753 753 236 116 116 116 116 116 116 116 116 116 116 116 
753 753 753 753 875 0 0 0 0 873 753 753 196 197 197 197 197 198 753 753 875 0 0 0 0 873 753 753 236 116 116 116 116 116 116 116 116 116 116 116 
753 753 753 753 875 0 0 0 0 873 753 753 236 116 116 116 116 238 753 753 875 0 0 0 0 873 753 753 236 116 116 116 116 116 116 116 116 116 116 116 
753 753 753 753 875 0 0 0 0 873 753 753 236 116 116 116 116 238 753 753 875 0 0 0 0 873 753 753 236 116 116 116 116 116 116 116 116 116 116 116 
753 753 753 753 875 0 0 0 0 873 753 753 236 116 116 116 116 238 753 753 875 0 0 0 0 873 753 753 236 116 116 116 116 116 116 116 116 116 116 116 
753 753 753 753 794 834 834 834 834 795 753 753 236 116 116 116 116 238 753 753 794 834 834 834 834 795 753 753 236 116 116 116 116 116 116 116 116 116 116 116 
753 753 753 753 753 753 753 753 753 753 753 753 236 116 116 116 116 238 753 753 753 753 753 753 753 753 753 753 236 116 116 116 116 116 116 116 116 116 116 116 
753 753 753 753 753 753 753 753 753 753 753 753 236 116 116 116 116 238 914 914 755 753 753 753 753 754 914 914 236 116 116 116 116 116 116 116 116 116 116 116 
197 197 197 197 197 197 197 197 197 197 197 197 158 116 116 116 116 238 0 0 873 753 753 753 753 875 0 0 236 116 116 116 116 116 116 116 116 116 116 116 
116 116 116 116 116 116 116 116 116 116 116 116 116 116 116 116 116 238 0 0 913 914 914 914 914 915 0 0 236 116 116 116 116 116 116 116 116 116 116 116 
116 116 116 116 116 116 116 116 116 116 116 116 116 116 116 116 116 238 0 0 0 0 0 0 0 0 0 0 236 116 116 116 116 116 116 116 116 116 116 116 
116 116 116 116 116 116 116 116 116 116 116 116 116 116 116 116 116 238 0 0 0 0 0 0 0 0 0 0 236 116 116 116 116 116 116 116 116 116 116 116 
116 116 116 116 116 116 116 116 116 116 116 116 116 116 116 116 116 238 0 0 0 0 0 0 0 0 0 0 236 116 116 116 116 116 116 116 116 116 116 116 
0
