0 0 0 0 0 0 0 0 0 0 0 0 0 0 0 0 0 0 0 606 486 486 486 486 486 486 486 486 486 486 486 486 486 486 486 486 486 486 486 486 
0 0 0 0 0 0 0 0 0 0 0 0 0 0 0 0 0 0 0 606 486 486 486 486 486 486 486 486 486 486 486 486 486 486 486 486 486 486 486 486 
0 0 0 0 0 0 0 0 0 0 0 0 0 0 0 0 0 0 0 606 486 486 486 486 486 486 486 486 486 486 486 486 486 486 486 486 486 486 486 486 
0 0 0 0 0 0 0 0 0 0 0 0 0 0 0 0 0 0 0 606 486 486 486 486 486 486 486 486 486 486 486 486 486 486 486 486 486 486 486 486 
0 0 0 0 0 0 0 0 0 0 0 0 0 0 0 0 0 0 0 606 486 486 486 486 486 486 486 486 486 486 486 486 486 486 486 486 486 486 486 486 
0 0 0 0 0 0 0 0 0 0 0 0 0 0 0 0 0 0 0 606 486 486 486 486 486 486 486 486 486 486 486 486 486 486 486 486 486 486 486 486 
0 0 0 0 0 0 0 0 0 0 0 0 0 0 0 0 0 0 0 606 486 486 486 486 486 486 486 486 486 486 486 486 486 486 486 486 486 486 486 486 
0 0 0 0 0 0 0 0 0 0 0 0 0 0 0 0 0 0 0 606 486 486 486 486 486 486 486 486 486 486 486 486 486 486 486 486 486 486 486 486 
0 0 0 0 0 0 0 0 0 0 0 0 0 0 0 0 0 0 0 606 486 486 486 486 486 486 486 486 486 486 486 486 486 486 486 486 486 486 486 486 
0 0 0 0 0 0 0 0 0 0 0 0 0 0 0 0 0 0 0 606 486 486 486 486 486 486 486 486 486 486 486 486 486 486 486 486 486 486 486 486 
0 0 0 0 0 0 0 0 0 0 0 0 0 0 0 0 0 0 0 606 486 486 486 486 486 486 486 486 486 486 486 486 486 486 486 486 486 486 486 486 
0 0 0 0 0 0 0 0 0 0 0 0 0 0 0 0 0 0 0 606 486 486 486 486 486 486 486 486 486 486 486 486 486 486 486 486 486 486 486 486 
0 0 0 0 0 0 0 0 0 0 0 0 0 0 0 0 0 0 0 606 486 486 486 486 486 486 486 486 486 486 486 486 486 486 486 486 486 486 486 486 
0 0 0 0 0 0 0 0 0 0 0 0 0 0 0 0 0 0 0 646 647 647 647 647 647 647 647 647 647 647 647 647 647 647 647 647 647 647 647 647 
0 0 0 0 0 0 0 0 0 0 0 0 0 0 0 0 0 0 0 0 0 0 0 0 0 0 0 0 0 0 0 0 0 0 0 0 0 0 0 0 
0 0 0 0 0 0 0 0 0 0 0 0 0 0 0 0 0 0 0 0 0 0 0 0 0 0 0 0 0 0 0 0 0 0 0 0 0 0 0 0 
0 0 0 0 0 0 0 0 0 0 0 0 0 0 0 0 0 0 0 0 0 0 0 0 0 0 0 0 0 0 0 0 0 0 0 0 0 0 0 0 
0 0 0 0 0 0 0 0 0 0 0 0 0 0 0 0 0 0 0 0 0 0 0 0 0 0 0 0 0 0 0 0 0 0 0 0 0 0 0 0 
0 0 0 0 0 0 0 0 0 0 0 0 0 0 0 0 0 0 0 0 0 0 0 0 0 0 0 0 0 0 0 0 0 0 0 0 0 0 0 0 
0 0 0 0 0 0 0 0 0 0 0 0 0 0 0 0 0 0 0 0 0 0 0 0 0 0 0 0 0 0 0 0 0 0 0 0 0 0 0 0 
0 0 0 0 0 0 0 0 0 0 0 0 0 0 0 0 0 0 0 0 0 0 0 0 0 0 0 0 0 0 0 0 0 0 0 0 0 0 0 0 
0 0 0 0 0 0 0 0 0 0 0 0 0 0 0 0 0 0 0 0 0 0 0 0 0 0 0 0 0 0 0 0 0 0 0 0 0 0 0 0 
0 0 0 0 0 0 0 0 0 0 0 0 0 0 0 0 0 0 0 0 0 0 0 0 0 0 0 0 0 0 0 0 0 0 0 0 0 0 0 0 
0 0 0 0 0 0 0 0 0 0 0 0 0 0 0 0 0 0 0 0 0 0 0 0 0 0 0 0 0 0 0 0 0 0 0 0 0 0 0 0 
0 0 0 0 0 0 0 0 0 0 0 0 0 0 0 0 0 0 0 0 0 0 0 0 0 0 0 0 0 0 0 0 0 0 0 0 0 0 0 0 
0 0 0 0 0 0 0 0 0 0 0 0 0 0 0 0 0 0 0 0 0 0 0 0 0 0 0 0 0 0 0 0 0 0 0 0 0 0 0 0 
0 0 0 0 0 0 0 0 0 0 0 0 0 0 0 0 0 0 0 0 0 0 0 0 0 0 0 0 0 0 0 0 0 0 0 0 0 0 0 0 
0 0 0 0 0 0 0 0 0 0 0 0 0 0 0 0 0 0 0 0 0 0 0 0 0 0 0 0 0 0 0 0 0 0 0 0 0 0 0 0 
0 0 0 0 0 0 0 0 0 0 0 0 0 0 0 0 0 0 0 0 0 0 0 0 0 0 0 0 0 0 0 0 0 0 0 0 0 0 0 0 
0 0 0 0 0 0 0 0 0 0 0 0 0 0 0 0 0 0 0 0 0 0 0 0 0 0 0 0 0 0 0 0 0 0 0 0 0 0 0 0 
0
