489 489 489 489 489 489 489 489 489 489 489 489 489 489 489 489 489 489 611 0 0 0 0 0 0 0 0 0 0 0 0 0 0 0 0 0 0 0 0 0 
489 489 489 489 489 489 489 489 489 489 489 489 489 489 489 489 489 489 611 0 0 0 0 0 0 0 0 0 0 0 0 0 0 0 0 0 0 0 0 0 
489 489 489 489 489 489 489 489 489 489 489 489 489 489 489 489 489 489 611 0 0 0 0 0 0 0 0 0 0 0 0 0 0 0 0 0 0 0 0 0 
489 489 489 489 489 489 489 489 489 489 489 489 489 489 489 489 489 489 611 0 0 0 0 0 0 0 0 0 0 0 0 0 0 0 0 0 0 0 0 0 
489 489 489 489 489 489 489 489 489 489 489 489 489 489 489 489 489 489 611 0 0 0 0 0 0 0 0 0 0 0 0 0 0 0 0 0 0 0 0 0 
489 489 489 489 489 489 489 489 489 489 489 489 489 489 489 489 489 489 611 0 0 0 0 0 0 0 0 0 0 0 0 0 0 0 0 0 0 0 0 0 
489 489 489 489 489 489 489 489 489 489 489 489 489 489 489 489 489 489 611 0 0 0 0 0 0 0 0 0 0 0 0 0 0 0 0 0 0 0 0 0 
489 489 489 489 489 489 489 489 489 489 489 489 489 489 489 489 489 489 530 570 570 571 0 0 0 0 0 0 0 0 0 0 0 0 0 0 0 0 0 0 
489 489 489 489 489 489 489 489 489 489 489 489 489 489 489 489 489 489 489 489 489 530 570 570 571 0 0 0 0 0 0 0 0 0 0 0 0 0 0 0 
489 489 489 489 489 489 489 489 489 489 489 489 489 489 489 489 489 489 489 489 489 489 489 489 530 570 570 571 0 0 0 0 0 0 0 0 0 0 0 0 
489 489 489 489 489 489 489 489 489 489 489 489 489 489 489 489 489 489 489 489 489 489 489 489 489 489 489 611 0 0 0 0 0 0 0 0 0 0 0 0 
489 489 489 489 489 489 489 489 489 489 489 489 489 489 489 489 489 489 489 489 489 489 489 489 489 489 489 611 0 0 0 0 0 0 0 0 0 0 0 0 
489 489 489 489 489 489 489 490 650 650 650 650 650 650 650 650 650 650 491 489 489 489 489 489 490 650 650 651 0 0 0 0 0 0 0 0 0 0 0 0 
489 489 489 489 489 489 489 611 0 0 0 0 0 0 0 0 0 0 649 650 650 650 650 650 651 0 0 0 0 0 0 0 0 0 0 0 0 0 0 0 
489 489 489 489 489 489 489 611 0 0 0 0 0 0 0 0 0 0 0 0 0 0 0 0 0 0 0 0 0 0 0 0 0 0 0 0 0 0 0 0 
489 489 489 489 489 489 489 611 0 0 0 0 0 0 0 0 0 0 0 0 0 0 0 0 0 0 0 0 0 0 0 0 0 0 0 0 0 0 0 0 
489 489 489 489 489 489 489 611 0 0 0 0 0 0 0 0 0 0 0 0 0 0 0 0 0 0 0 0 0 0 0 0 0 0 0 0 0 0 0 0 
489 489 489 489 489 489 489 611 0 0 0 0 0 0 0 0 0 0 0 0 0 0 0 0 0 0 0 0 0 0 0 0 0 0 0 0 0 0 0 0 
489 489 489 489 489 489 489 530 570 570 570 570 570 570 570 570 570 570 570 570 571 0 0 0 0 0 0 0 0 0 0 0 0 0 0 0 0 0 0 0 
489 489 489 489 489 489 489 489 489 489 489 489 489 489 489 489 489 489 489 489 611 0 0 0 0 0 0 0 0 0 0 0 0 0 0 0 0 0 0 0 
489 489 489 489 489 489 489 489 489 489 489 489 489 489 489 489 489 489 489 489 611 0 0 0 0 0 0 0 0 0 0 0 0 0 0 0 0 0 0 0 
489 489 489 489 489 489 489 489 489 489 489 489 489 489 489 489 489 489 489 490 651 0 0 0 0 0 0 0 0 0 0 0 0 0 0 0 0 0 0 0 
489 489 489 489 489 489 489 489 489 489 489 489 489 489 489 489 489 489 489 611 0 0 0 0 0 0 0 0 0 0 0 0 0 0 0 0 0 0 0 0 
489 489 489 489 489 489 489 489 489 489 489 489 489 489 489 489 489 489 489 611 0 0 0 0 0 0 0 0 0 0 0 0 0 0 0 0 0 0 0 0 
489 489 489 489 489 489 489 489 489 489 489 489 489 489 489 489 489 489 489 611 0 0 0 0 0 0 0 0 0 0 0 0 0 0 0 0 0 0 0 0 
489 489 489 489 489 489 489 489 489 489 489 489 489 489 489 489 489 489 490 651 0 0 0 0 0 0 0 0 0 0 0 0 0 0 0 0 0 0 0 0 
489 489 489 489 489 489 489 489 489 489 489 489 489 489 489 489 489 489 611 0 0 0 0 0 0 0 0 0 0 0 0 0 0 0 0 0 0 0 0 0 
489 489 489 489 489 489 489 489 489 489 489 489 489 489 489 489 489 489 611 0 0 0 0 0 0 0 0 0 0 0 0 0 0 0 0 0 0 0 0 0 
489 489 489 489 489 489 489 489 489 489 489 489 489 489 489 489 489 489 611 0 0 0 0 0 0 0 0 0 0 0 0 0 0 0 0 0 0 0 0 0 
489 489 489 489 489 489 489 489 489 489 489 489 489 489 489 489 489 489 611 0 0 0 0 0 0 0 0 0 0 0 0 0 0 0 0 0 0 0 0 0 
0
