480 480 480 480 480 480 480 480 480 480 480 480 480 480 480 480 480 480 480 480 480 480 480 480 480 480 480 480 480 480 480 480 480 480 480 480 480 480 480 480 
480 480 480 480 480 480 480 480 480 480 480 480 480 480 480 480 480 480 480 480 480 480 480 480 480 480 480 480 480 480 480 480 480 480 480 480 480 480 480 480 
480 480 480 480 480 480 480 480 480 480 480 480 480 480 480 480 480 480 480 480 480 480 480 480 480 480 480 480 480 480 480 480 480 480 480 480 480 480 480 480 
480 480 480 480 480 480 480 480 480 480 480 480 480 480 480 480 480 480 480 480 480 480 480 480 480 480 480 480 480 480 480 480 480 480 480 480 480 480 480 480 
480 480 480 480 480 480 480 480 480 480 480 480 480 480 480 480 480 480 480 480 480 480 480 480 480 480 480 480 480 480 480 480 480 480 480 480 480 480 480 480 
480 480 480 480 480 480 480 480 480 480 480 480 480 480 480 480 480 480 480 480 480 480 480 480 480 480 480 480 480 480 480 480 480 480 480 480 480 480 480 480 
480 480 480 480 480 480 480 480 480 480 480 480 480 480 480 480 480 480 480 480 480 480 480 480 480 480 480 480 480 480 480 480 480 480 480 480 480 480 480 480 
480 480 480 480 480 480 480 480 480 480 480 480 480 480 480 480 480 480 480 480 480 480 480 480 480 480 480 480 480 480 480 480 480 480 480 480 480 480 480 480 
480 480 480 480 480 480 480 480 480 480 480 480 480 480 480 480 480 480 480 480 480 480 480 480 480 480 480 480 480 480 480 480 480 480 480 480 480 480 480 480 
480 480 480 480 480 480 480 480 480 480 480 480 480 480 480 480 480 480 480 480 480 480 480 480 480 480 480 480 480 480 480 480 480 480 480 480 480 480 480 480 
480 480 480 480 480 480 480 480 480 480 480 480 480 480 480 480 480 480 480 480 480 480 480 480 480 480 480 480 480 480 480 480 480 480 480 480 480 480 480 480 
641 641 641 641 641 641 641 641 641 641 641 641 641 641 641 641 641 641 641 641 641 641 641 641 641 641 641 641 641 641 641 641 641 641 641 641 641 641 641 641 
0 0 0 0 680 0 0 0 0 0 0 0 0 0 0 680 0 0 0 0 0 0 0 0 680 0 0 0 0 0 0 0 0 0 0 680 0 0 0 0 
0 0 0 0 680 0 0 0 0 0 0 0 0 0 0 680 0 0 0 0 0 0 0 0 680 0 0 0 0 0 0 0 0 0 0 680 0 0 0 0 
0 0 0 0 680 0 0 0 0 0 0 0 0 0 0 680 0 0 0 0 0 0 0 0 680 0 0 0 0 0 0 0 0 0 0 680 0 0 0 0 
0 0 0 0 680 0 0 0 0 0 0 0 0 0 0 680 0 0 0 0 0 0 0 0 680 0 0 0 0 0 0 0 0 0 0 680 0 0 0 0 
0 0 0 0 680 0 0 0 0 0 0 0 0 0 0 680 0 0 0 0 0 0 0 0 680 0 0 0 0 0 0 0 0 0 0 680 0 0 0 0 
0 0 0 0 680 0 0 0 0 0 0 0 0 0 0 680 0 0 0 0 0 0 0 0 680 0 0 0 0 0 0 0 0 0 0 680 0 0 0 0 
561 561 561 561 561 561 561 561 561 562 0 0 0 0 0 680 0 0 0 0 0 0 560 561 561 561 561 561 561 561 561 561 561 561 561 561 561 561 561 561 
480 480 480 480 480 480 480 480 480 602 0 0 0 0 0 680 0 0 0 0 0 0 600 480 480 480 480 480 480 480 480 480 480 480 480 480 480 480 480 480 
480 480 480 480 480 480 480 480 480 602 0 0 0 0 0 680 0 0 0 0 0 0 600 480 480 480 480 480 480 480 480 480 480 480 480 480 480 480 480 480 
480 480 480 480 480 480 480 480 480 521 561 561 561 561 561 561 561 562 0 0 0 0 600 480 480 480 480 480 480 480 480 480 480 480 480 480 480 480 480 480 
480 480 480 480 480 480 480 480 480 480 480 480 480 480 480 480 480 602 681 681 681 681 600 480 480 480 480 480 480 480 480 480 480 480 480 480 480 480 480 480 
480 480 480 480 480 480 480 480 480 480 480 480 480 480 480 481 641 642 0 0 0 0 640 641 482 480 480 480 480 480 480 480 480 480 480 480 480 480 480 480 
480 480 480 480 480 480 480 480 480 480 480 480 480 480 480 602 0 0 0 0 0 0 0 0 600 480 480 480 480 480 480 480 480 480 480 480 480 480 480 480 
480 480 480 480 480 480 480 480 480 480 480 480 480 480 480 602 0 0 0 0 0 0 0 0 600 480 480 480 480 480 480 480 480 480 480 480 480 480 480 480 
480 480 480 480 480 480 480 480 480 480 480 480 480 480 480 602 681 681 681 681 681 681 681 681 600 480 480 480 480 480 480 480 480 480 480 480 480 480 480 480 
480 480 480 480 480 480 480 480 480 480 480 480 480 480 480 602 0 0 0 0 0 0 0 0 600 480 480 480 480 480 480 480 480 480 480 480 480 480 480 480 
480 480 480 480 480 480 480 480 480 480 480 480 480 480 480 602 0 0 0 0 0 0 0 0 600 480 480 480 480 480 480 480 480 480 480 480 480 480 480 480 
480 480 480 480 480 480 480 480 480 480 480 480 480 480 480 602 0 0 0 0 0 0 0 0 600 480 480 480 480 480 480 480 480 480 480 480 480 480 480 480 
0
