489 489 489 489 489 489 489 489 489 489 489 489 489 489 489 489 489 489 489 489 489 489 489 489 489 489 489 489 489 489 489 489 489 489 489 489 489 489 489 489 
489 489 490 650 650 650 650 650 491 489 489 489 489 489 489 489 489 489 489 489 489 489 489 489 489 489 489 489 489 489 489 489 489 489 489 489 489 489 489 489 
489 489 611 166 167 167 167 168 609 489 489 489 489 489 489 489 489 489 490 650 650 650 491 489 489 489 489 489 489 489 489 489 489 489 489 489 489 489 489 489 
489 489 611 206 86 86 86 208 609 489 489 489 489 489 489 489 489 489 611 166 167 168 609 489 489 489 489 489 489 489 489 489 489 489 489 489 489 489 489 489 
489 489 611 206 86 86 86 208 609 489 489 489 489 489 489 489 489 489 611 206 86 208 609 489 489 489 489 489 489 489 489 489 489 489 489 489 489 489 489 489 
489 489 611 206 86 86 86 208 609 489 489 489 489 489 489 489 489 489 611 246 247 248 609 489 489 489 489 489 489 489 489 489 489 489 489 489 489 489 489 489 
489 489 611 246 247 247 247 248 609 489 489 489 489 489 489 489 489 489 530 570 570 570 531 489 489 489 489 490 650 650 650 650 650 650 650 650 650 650 650 650 
489 489 530 570 570 570 570 570 531 489 489 489 489 489 489 489 489 489 489 489 489 489 489 489 489 489 489 611 166 167 167 167 168 166 167 167 167 167 167 167 
489 489 489 489 489 489 489 489 489 489 489 489 489 489 489 489 489 489 489 489 489 489 489 489 489 489 489 611 206 86 86 86 208 206 86 86 86 86 86 86 
489 489 489 489 489 489 489 489 489 489 489 489 489 489 489 489 489 489 489 489 489 489 489 489 489 489 489 611 206 86 86 86 208 206 86 87 247 247 247 247 
489 489 489 489 489 489 489 489 489 489 489 489 489 489 489 489 489 489 489 489 489 489 489 489 489 489 489 611 206 86 86 86 208 206 86 208 207 207 207 207 
650 650 650 650 650 650 650 650 650 650 650 650 650 650 491 489 489 489 489 489 489 489 489 489 489 489 489 611 206 86 86 86 208 206 86 208 207 207 207 207 
0 0 0 0 0 0 0 0 0 0 0 0 0 0 609 489 489 489 489 489 489 489 489 489 489 489 489 611 206 86 86 86 208 206 86 208 207 207 207 207 
0 0 0 0 0 0 0 0 0 0 0 0 0 0 609 489 489 489 489 489 489 489 489 489 489 489 489 611 206 86 86 86 208 206 86 208 207 207 207 207 
0 0 0 0 0 0 0 0 0 0 0 0 0 0 609 489 489 489 489 489 489 489 489 489 489 489 489 611 206 86 86 86 208 206 86 208 207 207 207 207 
0 0 0 0 0 0 0 0 0 0 0 0 0 0 609 489 489 489 489 489 489 489 489 489 489 489 489 611 206 86 86 86 208 206 86 208 207 207 207 207 
0 0 0 0 0 0 0 0 0 0 0 0 0 0 609 489 489 489 489 489 489 489 489 489 489 489 489 611 206 86 86 86 208 206 86 208 207 207 207 207 
0 0 0 0 0 0 0 0 0 0 0 0 0 0 609 489 489 489 489 489 489 489 489 489 489 489 489 611 206 86 86 86 208 206 86 208 207 207 207 207 
570 570 570 570 570 570 570 570 570 570 570 570 570 570 531 489 489 489 489 489 489 489 489 489 489 489 489 611 246 247 247 247 248 206 86 208 207 207 207 207 
489 489 489 489 489 489 489 489 489 489 489 489 489 489 489 489 489 489 489 489 489 489 489 489 489 489 489 530 570 570 570 570 571 206 86 208 207 207 207 207 
489 489 489 489 489 489 489 489 489 489 489 489 489 489 489 489 489 489 489 489 489 489 489 489 489 489 489 489 489 489 489 489 611 206 86 208 207 207 207 207 
489 489 489 489 489 489 489 489 489 489 489 489 489 489 489 489 489 489 489 489 489 489 489 489 489 489 489 489 489 489 489 489 611 206 86 127 167 167 167 167 
489 489 489 489 489 489 489 489 489 489 490 650 650 650 491 489 489 489 489 489 489 489 489 489 489 489 489 489 489 489 489 489 611 206 86 86 86 86 86 86 
489 489 489 489 489 489 489 489 489 489 611 166 167 168 609 489 489 489 489 489 489 489 489 489 489 489 489 489 489 489 489 489 611 246 247 247 247 247 247 247 
489 489 489 489 489 489 489 489 489 489 611 206 86 208 609 489 489 489 489 489 489 489 489 489 489 489 489 489 489 489 489 489 530 570 570 570 570 570 570 570 
489 489 489 489 489 489 489 489 489 489 611 246 247 248 609 489 489 489 489 489 489 489 489 489 489 489 489 489 489 489 489 489 489 489 489 489 489 489 489 489 
489 489 489 489 489 489 489 489 489 489 530 570 570 570 531 489 489 489 489 489 489 489 489 489 489 489 489 489 489 489 489 489 489 489 489 489 489 489 489 489 
489 489 489 489 489 489 489 489 489 489 489 489 489 489 489 489 489 489 489 489 489 489 489 489 489 489 489 489 489 489 489 489 489 489 489 489 489 489 489 489 
489 489 489 489 489 489 489 489 489 489 489 489 489 489 489 489 489 489 489 489 489 489 489 489 489 489 489 489 489 489 489 489 489 489 489 489 489 489 489 489 
489 489 489 489 489 489 489 489 489 489 489 489 489 489 489 489 489 489 489 489 489 489 489 489 489 489 489 489 489 489 489 489 489 489 489 489 489 489 489 489 
0
