289 289 289 289 289 289 289 289 289 289 289 289 289 289 289 289 289 289 289 289 289 289 289 289 289 289 289 289 289 289 289 289 289 289 289 289 289 289 289 289 
289 289 289 289 289 290 450 450 450 450 450 450 450 450 450 450 450 450 450 291 289 289 289 290 450 450 450 450 450 450 450 450 450 450 450 450 450 291 289 289 
289 289 289 289 289 411 70 70 70 70 70 70 70 70 70 70 70 70 70 409 289 289 289 411 70 70 70 70 70 70 70 70 70 70 70 70 70 409 289 289 
289 289 289 289 289 411 0 0 0 0 0 0 0 0 0 0 0 0 0 409 289 289 289 411 0 0 0 0 0 0 0 0 0 0 0 0 0 409 289 289 
289 289 289 289 289 411 0 0 0 0 0 0 0 0 0 0 0 0 0 409 289 289 289 411 0 0 0 0 0 0 0 0 0 0 0 0 0 409 289 289 
289 289 289 289 289 411 0 0 0 0 0 0 0 0 0 0 0 0 0 409 289 289 289 411 0 0 0 0 0 0 0 0 0 0 0 0 0 409 289 289 
289 289 289 289 289 411 0 0 0 0 0 0 0 0 0 0 0 0 0 409 289 289 289 411 0 0 0 0 0 0 0 0 0 0 0 0 0 409 289 289 
289 289 289 289 289 411 0 0 0 0 0 0 0 0 0 0 0 0 0 409 289 289 289 411 0 0 0 0 0 0 0 0 0 0 0 0 0 409 289 289 
289 289 289 289 289 411 0 0 0 0 0 0 0 0 0 0 0 0 0 409 289 289 289 411 0 0 0 0 0 0 0 0 0 0 0 0 0 409 289 289 
289 290 450 450 450 451 0 0 0 0 0 0 0 0 0 0 0 0 0 449 450 450 450 451 0 0 0 0 0 0 0 0 0 0 0 0 0 449 450 450 
289 411 70 70 70 70 0 0 0 0 0 0 0 0 0 0 0 0 0 70 70 70 70 70 0 0 0 0 0 0 0 0 0 0 0 0 0 0 0 0 
289 411 0 0 0 0 0 0 0 0 0 0 0 0 0 0 0 0 0 0 0 0 0 0 0 0 0 0 0 0 0 0 0 0 0 0 0 0 0 0 
289 411 0 0 0 0 0 0 0 0 0 0 0 0 0 0 0 0 0 0 0 0 0 0 0 0 0 0 0 0 0 0 0 0 0 0 0 0 0 0 
289 411 0 0 0 0 0 0 0 0 0 0 0 0 0 0 0 0 0 0 0 0 0 0 0 0 0 0 0 0 0 0 0 0 0 0 0 0 0 0 
289 411 0 0 0 0 0 0 0 0 0 0 0 0 0 0 0 0 0 0 0 0 0 0 0 0 0 0 0 0 0 0 0 0 0 0 0 0 0 0 
289 411 0 0 0 0 0 0 0 0 0 0 0 0 0 0 0 0 0 0 0 0 0 0 0 0 0 0 0 0 0 0 0 0 0 0 0 0 0 0 
289 411 0 0 0 0 0 0 0 0 0 0 0 0 0 0 0 0 0 0 0 0 0 0 0 0 0 0 0 0 0 0 0 0 0 0 0 0 0 0 
289 411 0 0 0 0 0 0 0 0 0 0 0 0 0 0 0 0 0 0 0 0 0 0 0 0 0 0 0 0 0 0 0 0 0 0 0 0 0 0 
289 411 0 0 0 0 0 0 0 0 0 69 69 69 0 0 0 0 0 0 0 0 0 0 0 0 0 0 0 0 0 0 0 0 0 0 0 0 0 0 
289 411 0 0 0 0 0 0 0 0 0 369 370 371 0 0 0 0 0 0 0 0 0 0 0 0 0 0 0 369 370 370 370 370 370 370 370 370 370 370 
289 411 0 0 0 0 0 0 0 0 0 409 289 411 0 0 0 0 0 0 0 0 0 0 0 0 0 0 0 409 289 289 289 289 289 289 289 289 289 289 
289 411 0 0 0 0 0 0 0 0 0 409 289 411 0 0 0 0 0 0 0 0 0 0 0 0 0 0 0 409 289 289 289 289 289 289 289 289 289 289 
289 411 0 0 0 0 0 0 0 0 0 409 289 411 0 0 0 0 0 0 0 0 0 0 0 0 0 0 0 409 289 289 289 289 289 289 289 289 289 289 
289 411 0 0 0 0 0 0 0 0 0 409 289 411 69 69 69 69 69 0 0 0 0 0 69 69 69 69 69 409 289 289 289 289 289 289 289 289 289 289 
289 411 0 0 0 0 0 0 0 0 0 409 289 330 370 370 370 370 371 0 0 0 0 0 369 370 370 370 370 331 289 289 289 289 289 289 289 289 289 289 
289 411 0 0 0 0 0 0 0 0 0 409 289 289 289 289 289 289 411 0 0 0 0 0 409 289 289 289 289 289 289 289 289 289 289 289 289 289 289 289 
289 411 0 0 0 0 0 0 0 0 0 409 289 289 289 289 289 289 411 0 0 0 0 0 409 289 289 289 289 289 289 289 289 289 289 289 289 289 289 289 
289 411 0 0 0 0 0 0 0 0 0 409 289 289 289 289 289 289 330 370 370 370 370 370 331 289 289 289 289 289 289 289 289 289 289 289 289 289 289 289 
289 411 0 0 0 0 0 0 0 0 0 409 289 289 289 289 289 289 289 289 289 289 289 289 289 289 289 289 289 289 289 289 289 289 289 289 289 289 289 289 
4
35 17 10 1
6 6 11 104
24 6 11 104
19 24 11 40
