283 283 283 283 283 283 283 283 283 284 444 444 444 444 444 444 444 445 53 0 0 0 0 0 0 0 54 403 283 405 0 0 0 0 0 0 403 283 283 283 
283 283 283 283 283 283 283 283 284 445 66 66 66 66 66 66 66 66 0 0 0 0 0 0 0 0 54 403 283 405 0 0 0 0 0 0 403 283 283 283 
283 283 283 283 283 283 283 283 405 53 0 0 0 0 0 0 0 0 0 0 0 0 0 0 0 0 54 403 283 405 0 0 0 0 0 0 403 283 283 283 
283 283 283 283 283 283 283 283 405 53 0 0 0 0 0 0 0 0 0 0 0 0 0 0 0 0 54 403 283 405 0 0 0 0 0 0 403 283 283 283 
283 283 283 283 283 283 283 283 405 53 0 0 0 0 0 0 0 0 0 0 0 0 0 0 0 0 54 403 283 405 0 0 0 0 0 0 403 283 283 283 
283 283 283 283 283 283 283 283 405 53 0 0 0 0 0 0 0 0 0 0 0 0 0 0 0 0 54 403 283 405 0 0 0 0 0 0 403 283 283 283 
283 283 283 283 283 283 283 283 405 53 0 0 0 0 0 0 0 0 0 0 0 0 0 0 0 0 54 403 283 405 0 0 0 0 0 0 403 283 283 283 
283 283 283 283 283 283 283 283 405 53 0 0 0 0 0 0 0 0 0 0 0 0 0 0 0 0 54 403 283 405 0 0 0 363 364 364 325 283 283 283 
283 283 283 283 283 283 283 283 405 53 0 0 0 0 0 0 0 0 0 0 0 0 0 0 0 0 54 403 283 405 0 0 0 443 444 444 444 444 285 283 
283 283 283 283 283 283 283 283 405 53 0 0 0 0 0 0 0 0 0 0 0 0 0 0 0 0 54 403 283 405 0 0 0 0 0 0 0 0 403 283 
283 283 283 283 283 283 283 283 405 53 0 0 0 0 0 0 0 0 0 0 0 0 0 0 0 0 54 403 283 405 0 0 0 0 0 0 0 0 403 283 
283 283 283 283 283 283 283 283 405 53 0 0 0 0 0 0 0 65 0 0 0 0 0 0 0 0 54 403 283 405 0 0 0 0 0 0 0 0 403 283 
283 283 283 283 283 283 283 283 405 53 0 0 0 0 0 0 54 393 53 0 0 0 0 0 0 0 54 403 283 405 0 0 0 0 0 0 0 0 403 283 
283 283 283 283 283 283 283 283 405 53 0 0 0 0 0 0 54 433 53 0 0 0 0 0 0 0 54 403 283 405 0 0 0 0 0 0 0 0 403 283 
283 283 283 283 283 283 283 283 405 53 0 0 0 0 0 0 54 433 53 0 0 0 0 0 0 0 54 403 283 439 314 314 314 314 315 0 0 0 403 283 
283 283 283 283 283 283 283 283 405 53 0 0 0 0 0 0 54 433 53 0 0 0 0 0 0 0 54 403 283 405 0 0 0 0 0 0 0 0 403 283 
283 283 283 283 283 283 283 283 405 53 0 0 0 0 0 0 54 473 53 0 0 0 0 0 0 0 54 403 283 405 0 0 0 0 0 0 0 0 403 283 
283 283 283 283 283 283 283 283 405 53 0 0 0 0 0 0 0 66 0 0 0 0 0 0 0 0 54 403 283 405 0 0 0 0 0 0 0 0 403 283 
283 283 283 283 283 283 283 283 405 53 0 0 0 0 0 0 0 0 0 0 0 0 0 0 0 0 54 403 283 405 0 0 0 0 0 0 0 0 403 283 
283 283 283 283 283 283 283 283 405 53 0 0 0 0 0 0 0 0 0 0 0 0 0 0 0 0 54 403 283 405 0 0 0 0 0 0 0 0 403 283 
283 283 283 283 283 283 283 283 405 53 0 0 0 0 0 0 0 0 0 0 0 0 0 0 0 0 54 403 283 405 0 0 0 363 364 364 364 364 325 283 
283 283 283 283 283 283 283 283 405 53 0 0 0 0 0 0 0 0 0 0 0 0 0 0 0 0 54 403 283 405 0 0 0 443 444 444 285 283 283 283 
283 283 283 283 283 283 283 283 405 53 0 0 0 0 0 0 0 0 0 0 0 0 0 0 0 0 54 403 283 405 0 0 0 0 0 0 403 283 283 283 
283 283 283 283 283 283 283 283 405 53 0 0 0 0 0 0 0 0 0 0 0 0 0 0 0 0 54 403 283 405 0 0 0 0 0 0 403 283 283 283 
283 283 283 283 283 283 283 283 405 53 0 0 0 0 0 0 0 0 0 0 0 0 0 0 0 0 54 403 283 405 0 0 0 0 0 0 403 283 283 283 
283 283 283 283 283 283 283 283 405 53 0 0 0 0 0 0 0 0 0 0 0 0 0 0 0 0 54 403 283 405 0 0 0 0 0 0 403 283 283 283 
283 283 283 283 283 283 283 283 405 53 0 0 0 0 0 0 0 0 0 0 0 0 0 0 0 0 54 403 283 405 0 0 0 0 0 0 403 283 283 283 
283 283 283 283 283 283 283 283 324 365 65 65 65 65 65 65 65 65 0 0 0 0 0 0 0 0 54 403 283 405 0 0 0 0 0 0 403 283 283 283 
283 283 283 283 283 283 283 283 283 324 364 364 364 364 364 364 364 365 53 0 0 0 0 0 0 0 54 403 283 405 0 0 0 0 0 0 403 283 283 283 
4
34 18 10 1
19 14 11 56
17 2 12 72
17 18 12 72
