80 80 80 80 80 80 80 80 80 80 80 80 80 80 80 202 0 0 0 0 0 0 0 200 80 202 201 201 201 201 201 201 201 201 201 201 201 201 201 201 
80 80 80 80 80 80 80 80 80 80 80 80 80 80 80 202 0 0 0 0 0 0 0 200 80 202 201 201 201 201 201 201 201 201 201 201 201 201 201 201 
80 80 80 80 80 80 80 80 80 80 80 80 80 80 80 202 0 0 0 0 0 0 0 200 80 202 201 201 201 201 201 201 201 201 201 201 201 201 201 201 
241 241 241 241 241 241 241 241 241 241 241 241 241 241 241 242 0 0 0 0 0 0 0 200 80 202 201 201 201 201 201 201 201 201 201 201 201 201 201 201 
161 162 0 0 0 0 0 0 0 0 0 0 0 0 0 0 0 0 0 0 0 0 0 200 80 202 201 201 201 201 201 201 201 201 201 201 201 201 201 201 
80 202 0 160 161 161 161 161 161 161 161 161 161 161 161 162 0 0 0 0 0 0 0 200 80 202 201 201 201 201 201 201 201 201 201 201 201 201 201 201 
80 202 0 240 241 241 241 241 241 241 241 241 241 241 241 242 0 0 0 0 0 0 0 200 80 202 201 201 201 201 201 201 201 201 201 201 201 201 201 201 
80 202 0 160 162 0 0 0 0 0 0 0 0 0 0 0 0 0 0 0 0 0 0 200 80 202 201 201 201 201 201 201 201 201 201 201 201 201 201 201 
80 202 0 200 202 0 160 161 161 161 161 161 161 161 161 162 0 0 0 0 0 0 0 200 80 121 161 161 161 161 161 161 161 161 161 161 161 161 161 161 
80 202 0 200 202 0 240 241 241 241 241 241 241 241 241 242 0 0 0 0 0 0 0 200 80 80 80 80 80 80 80 80 80 80 80 80 80 80 80 80 
80 202 0 200 202 0 160 162 0 0 0 0 0 0 0 0 0 0 0 0 0 0 0 240 241 241 241 241 241 241 241 241 241 241 241 241 241 241 241 241 
80 202 0 200 202 0 200 202 0 160 161 161 161 161 161 162 0 0 0 0 0 0 0 0 0 0 0 0 0 0 0 0 0 0 0 0 0 0 0 0 
80 202 0 200 202 0 200 202 0 240 241 241 241 241 241 242 0 0 0 0 0 0 0 0 0 0 0 0 0 0 0 0 0 0 0 0 0 0 0 0 
80 202 0 200 202 0 200 202 0 160 162 0 0 0 0 0 0 0 0 0 0 0 0 0 0 0 0 0 0 0 0 0 0 0 0 0 0 0 0 0 
80 202 0 200 202 0 200 202 0 200 202 0 0 0 0 0 0 0 0 0 0 0 0 0 0 0 0 0 0 0 0 0 0 0 0 0 0 0 0 0 
80 202 0 200 202 0 200 202 0 200 202 0 0 0 0 0 0 0 0 0 0 0 0 0 0 0 0 0 0 0 0 0 0 0 0 0 0 0 0 0 
80 202 0 200 202 0 200 202 0 240 242 0 0 0 0 0 0 0 0 0 0 0 0 0 0 0 0 0 0 0 0 0 0 0 0 0 0 0 0 0 
80 202 0 200 202 0 200 202 0 160 161 161 161 161 161 162 0 0 0 0 0 0 0 0 0 0 0 0 0 0 0 0 0 0 0 0 0 0 0 0 
80 202 0 200 202 0 200 202 0 240 241 241 241 241 241 242 0 0 0 0 0 0 0 160 161 161 161 161 161 161 161 161 161 161 161 161 161 161 161 161 
80 202 0 200 202 0 240 242 0 0 0 0 0 0 0 0 0 0 0 0 0 0 0 200 80 80 80 80 80 80 80 80 80 80 80 80 80 80 80 80 
80 202 0 200 202 0 160 161 161 161 161 161 161 161 161 162 0 0 0 0 0 0 0 200 80 81 241 241 241 241 241 241 241 241 241 241 241 241 241 241 
80 202 0 200 202 0 240 241 241 241 241 241 241 241 241 242 0 0 0 0 0 0 0 200 80 202 201 201 201 201 201 201 201 201 201 201 201 201 201 201 
80 202 0 240 242 0 0 0 0 0 0 0 0 0 0 0 0 0 0 0 0 0 0 200 80 202 201 201 201 201 201 201 201 201 201 201 201 201 201 201 
80 202 0 160 161 161 161 161 161 161 161 161 161 161 161 162 0 0 0 0 0 0 0 200 80 202 201 201 201 201 201 201 201 201 201 201 201 201 201 201 
80 202 0 240 241 241 241 241 241 241 241 241 241 241 241 242 0 0 0 0 0 0 0 200 80 202 201 201 201 201 201 201 201 201 201 201 201 201 201 201 
241 242 0 0 0 0 0 0 0 0 0 0 0 0 0 0 0 0 0 0 0 0 0 200 80 202 201 201 201 201 201 201 201 201 201 201 201 201 201 201 
161 161 161 161 161 161 161 161 161 161 161 161 161 161 161 162 0 0 0 0 0 0 0 200 80 202 201 201 201 201 201 201 201 201 201 201 201 201 201 201 
80 80 80 80 80 80 80 80 80 80 80 80 80 80 80 202 0 0 0 0 0 0 0 200 80 202 201 201 201 201 201 201 201 201 201 201 201 201 201 201 
80 80 80 80 80 80 80 80 80 80 80 80 80 80 80 202 0 0 0 0 0 0 0 200 80 202 201 201 201 201 201 201 201 201 201 201 201 201 201 201 
0
