120 120 120 120 120 120 120 120 120 120 120 120 120 200 80 202 0 0 0 0 0 0 0 0 200 80 202 120 120 120 120 120 120 120 120 120 120 120 120 120 
120 120 120 120 120 120 120 120 120 120 120 120 120 200 80 202 0 0 0 0 0 0 0 0 200 80 202 120 120 120 120 120 120 120 120 120 120 120 120 120 
120 120 120 120 120 120 120 120 120 120 120 120 120 200 80 202 0 0 0 0 0 0 0 0 200 80 202 120 120 120 120 120 120 120 120 120 120 120 120 120 
161 161 161 161 161 161 161 161 161 161 161 161 161 122 80 202 0 0 0 0 0 0 0 0 200 80 202 120 120 120 120 120 120 120 120 120 120 120 120 120 
80 80 80 80 80 80 80 80 80 80 80 80 80 80 80 202 0 0 0 0 0 0 0 0 200 80 202 120 120 120 120 120 120 120 120 120 120 120 120 120 
241 241 241 241 241 241 241 241 241 241 241 241 241 241 241 242 0 0 0 0 0 0 0 0 200 80 202 120 120 120 120 120 120 120 120 120 120 120 120 120 
0 0 0 0 0 0 0 0 0 0 0 0 0 0 0 0 0 0 0 0 0 0 0 0 200 80 202 120 120 120 120 120 120 120 120 120 120 120 120 120 
0 0 0 0 0 0 0 0 0 0 0 0 0 0 0 0 0 0 0 0 0 0 0 0 200 80 202 120 120 120 120 120 120 120 120 120 120 120 120 120 
0 0 0 0 0 0 0 0 0 0 0 0 0 0 0 0 0 0 0 0 0 0 0 0 200 80 202 120 120 120 120 120 120 120 120 120 120 120 120 120 
0 0 0 0 0 0 0 0 0 0 0 0 0 0 0 0 0 0 0 0 0 0 0 0 200 80 202 120 120 120 120 120 120 120 120 120 120 120 120 120 
0 0 0 0 0 0 0 0 0 0 0 0 0 0 0 0 0 0 0 0 0 0 0 0 200 80 202 120 120 120 120 120 120 120 120 120 120 120 120 120 
0 0 0 0 0 0 0 0 0 0 0 0 0 0 0 0 0 0 0 0 0 0 0 0 200 80 202 120 120 120 120 120 120 120 120 120 120 120 120 120 
161 161 161 161 161 161 161 161 161 161 161 161 161 161 161 162 160 161 161 161 161 161 161 162 200 80 202 120 120 120 120 120 120 120 120 120 120 120 120 120 
80 80 80 80 80 80 80 80 80 80 80 80 80 80 80 202 200 80 80 80 80 80 80 202 200 80 202 120 120 120 120 120 120 120 120 120 120 120 120 120 
241 241 241 241 241 241 241 241 241 241 241 241 241 82 80 202 200 80 80 80 80 80 80 202 200 80 121 161 161 161 161 161 161 161 161 161 161 161 161 161 
120 120 120 120 120 120 120 120 120 120 120 120 120 200 80 202 200 80 80 80 80 80 80 202 200 80 80 80 80 80 80 80 80 80 80 80 80 80 80 80 
120 120 120 120 120 120 120 120 120 120 120 120 120 200 80 202 240 241 241 241 241 241 241 242 240 241 241 241 241 241 241 241 241 241 241 241 241 241 241 241 
120 120 120 120 120 120 120 120 120 120 120 120 120 200 80 202 0 0 0 0 0 0 0 0 0 0 0 0 0 0 0 0 0 0 0 0 0 0 0 0 
120 120 120 120 120 120 120 120 120 120 120 120 120 200 80 202 0 0 0 0 0 0 0 0 0 0 0 0 0 0 0 0 0 0 0 0 0 0 0 0 
120 120 120 120 120 120 120 120 120 120 120 120 120 200 80 202 0 0 0 0 0 0 0 0 0 0 0 0 0 0 0 0 0 0 0 0 0 0 0 0 
120 120 120 120 120 120 120 120 120 120 120 120 120 200 80 202 0 0 0 0 0 0 0 0 0 0 0 0 0 0 0 0 0 0 0 0 0 0 0 0 
120 120 120 120 120 120 120 120 120 120 120 120 120 200 80 202 0 0 0 0 0 0 0 0 0 0 0 0 0 0 0 0 0 0 0 0 0 0 0 0 
120 120 120 120 120 120 120 120 120 120 120 120 120 200 80 202 0 0 0 0 0 0 0 0 0 0 0 0 0 0 0 0 0 0 0 0 0 0 0 0 
120 120 120 120 120 120 120 120 120 120 120 120 120 200 80 202 0 0 0 0 0 0 0 0 160 161 161 161 161 161 161 161 161 161 161 161 161 161 161 161 
120 120 120 120 120 120 120 120 120 120 120 120 120 200 80 202 0 0 0 0 0 0 0 0 200 80 80 80 80 80 80 80 80 80 80 80 80 80 80 80 
120 120 120 120 120 120 120 120 120 120 120 120 120 200 80 202 0 0 0 0 0 0 0 0 200 80 81 241 241 241 241 241 241 241 241 241 241 241 241 241 
120 120 120 120 120 120 120 120 120 120 120 120 120 200 80 202 0 0 0 0 0 0 0 0 200 80 202 120 120 120 120 120 120 120 120 120 120 120 120 120 
120 120 120 120 120 120 120 120 120 120 120 120 120 200 80 202 0 0 0 0 0 0 0 0 200 80 202 120 120 120 120 120 120 120 120 120 120 120 120 120 
120 120 120 120 120 120 120 120 120 120 120 120 120 200 80 202 0 0 0 0 0 0 0 0 200 80 202 120 120 120 120 120 120 120 120 120 120 120 120 120 
1
36 21 10 1
