83 83 83 83 83 83 83 83 83 83 83 83 83 205 203 83 83 83 83 83 83 83 83 83 83 205 0 0 0 0 203 83 83 83 83 83 83 83 83 83 
83 83 83 83 83 83 83 83 83 83 83 83 83 205 203 83 83 83 83 83 83 83 83 83 83 205 0 0 0 0 203 83 83 83 83 83 83 83 83 83 
83 83 83 83 83 83 83 83 83 83 83 83 83 205 243 244 244 244 244 244 244 244 244 244 244 245 0 0 0 0 203 83 83 83 83 83 83 83 83 83 
83 83 83 83 83 83 83 83 83 83 83 83 83 205 163 164 165 163 164 164 164 164 164 164 164 165 0 0 0 0 203 83 83 83 83 83 83 83 83 83 
244 244 244 244 244 244 244 244 244 244 244 244 244 245 203 83 205 243 244 244 244 244 244 244 244 245 0 0 0 0 243 244 244 244 244 244 244 244 244 244 
0 0 0 0 0 0 0 0 0 0 0 0 0 0 243 244 245 0 0 0 0 0 0 0 0 0 0 0 0 0 0 0 0 0 0 0 0 0 0 0 
0 0 0 0 0 0 0 0 0 0 0 0 0 0 7 7 7 0 0 0 0 0 0 0 0 0 0 0 0 0 0 0 0 0 0 0 0 0 0 0 
0 0 0 0 0 0 0 0 0 0 0 0 0 0 6 6 6 0 0 0 0 0 0 0 0 0 0 0 0 0 0 0 0 0 0 0 0 0 0 0 
0 0 0 0 0 0 0 0 0 0 0 0 0 0 163 164 165 0 0 0 0 0 0 0 0 0 0 0 0 0 0 0 0 0 0 0 0 0 0 0 
164 164 164 164 164 164 165 49 50 163 165 0 0 0 203 83 205 163 164 164 164 164 164 164 164 165 0 0 0 0 163 164 165 49 50 163 164 165 163 164 
83 83 83 83 83 83 205 49 50 203 205 0 0 0 203 83 205 203 83 83 83 83 83 83 83 205 0 0 0 0 203 83 205 49 50 203 83 205 203 83 
244 244 244 244 244 244 245 49 50 243 245 0 0 0 203 83 205 243 244 244 244 244 244 244 244 245 0 0 0 0 203 83 205 49 50 203 83 205 243 244 
0 0 0 0 0 0 0 0 0 0 0 0 0 0 203 83 205 0 0 0 0 0 0 163 164 165 0 0 0 0 203 83 205 49 50 203 83 205 0 0 
0 0 0 0 0 0 0 0 0 0 0 0 0 0 203 83 205 0 0 0 0 0 0 203 83 205 163 164 164 165 203 83 205 49 50 203 83 205 0 0 
0 0 0 0 0 0 0 0 0 0 0 0 0 0 203 83 205 0 0 0 0 0 0 203 83 205 203 83 83 205 203 83 205 49 50 203 83 205 0 0 
0 0 0 0 0 0 0 0 0 0 0 0 0 0 203 83 205 0 0 0 0 0 0 203 83 205 203 83 83 205 203 83 205 49 50 203 83 205 0 0 
0 0 0 0 0 0 0 0 0 0 0 0 0 0 203 83 205 0 0 0 0 0 0 203 83 205 243 244 244 245 203 83 205 49 50 203 83 205 0 0 
0 0 0 0 0 0 0 0 0 0 0 0 0 0 203 83 205 0 0 0 0 0 0 203 83 205 0 0 0 0 203 83 205 49 50 203 83 205 0 0 
164 164 164 164 164 164 165 49 50 163 165 0 0 0 203 83 205 0 0 0 0 0 0 203 83 205 0 0 0 0 203 83 205 49 50 203 83 205 163 164 
83 83 83 83 83 83 205 49 50 203 205 0 0 0 203 83 205 0 0 0 0 0 0 203 83 205 0 0 0 0 203 83 205 49 50 203 83 205 203 83 
244 244 244 244 244 244 245 49 50 243 245 0 0 0 203 83 205 0 0 0 0 0 0 243 244 245 0 0 0 0 243 244 245 49 50 243 244 245 243 244 
0 0 0 0 0 0 0 0 0 0 0 0 0 0 243 244 245 0 0 0 0 0 0 0 0 0 0 0 0 0 0 0 0 0 0 0 0 0 0 0 
0 0 0 0 0 0 0 0 0 0 0 0 0 0 7 7 7 0 0 0 0 0 0 0 0 0 0 0 0 0 0 0 0 0 0 0 0 0 0 0 
0 0 0 0 0 0 0 0 0 0 0 0 0 0 6 6 6 0 0 0 0 0 0 0 0 0 0 0 0 0 0 0 0 0 0 0 0 0 0 0 
0 0 0 0 0 0 0 0 0 0 0 0 0 0 163 164 165 0 0 0 0 0 0 0 0 0 0 0 0 0 0 0 0 0 0 0 0 0 0 0 
164 164 164 164 164 164 164 164 164 164 164 164 164 165 203 83 205 163 164 164 164 164 164 164 164 165 0 0 0 0 163 164 164 164 164 164 164 164 164 164 
83 83 83 83 83 83 83 83 83 83 83 83 83 205 243 244 245 243 244 244 244 244 244 244 244 245 0 0 0 0 203 83 83 83 83 83 83 83 83 83 
83 83 83 83 83 83 83 83 83 83 83 83 83 205 163 164 164 164 164 164 164 164 164 164 164 165 0 0 0 0 203 83 83 83 83 83 83 83 83 83 
83 83 83 83 83 83 83 83 83 83 83 83 83 205 203 83 83 83 83 83 83 83 83 83 83 205 0 0 0 0 203 83 83 83 83 83 83 83 83 83 
6
19 14 9
3 16 10 1
7 6 1 0 8 -16 -16 336 256
33 6 1 0 8 -16 -16 336 256
19 6 1 2 4 -24 -24 344 256
19 22 1 2 4 -24 -16 344 256
