207 207 207 207 207 207 207 207 207 207 207 207 207 206 86 208 206 208 0 0 0 0 206 208 206 86 208 207 207 207 207 206 86 208 246 247 247 248 206 86 
207 207 207 207 207 207 207 207 207 207 207 207 207 206 86 208 206 208 0 0 0 0 206 208 206 86 208 207 207 207 207 206 86 208 0 0 0 0 206 86 
167 167 167 167 167 167 167 167 167 167 167 167 167 128 86 208 206 208 0 0 0 0 206 208 206 86 127 167 167 167 167 128 86 208 0 0 0 0 206 86 
86 86 86 86 86 86 86 86 86 86 86 86 86 86 86 208 206 208 0 0 0 0 206 208 206 86 86 86 86 86 86 86 86 208 0 0 0 0 206 86 
247 247 247 247 247 247 247 247 247 247 247 247 247 247 247 248 206 208 0 0 0 0 206 208 246 247 247 247 247 247 247 247 247 248 0 0 0 0 246 247 
0 0 0 0 0 0 0 0 0 0 0 0 0 0 0 0 246 248 0 0 0 0 246 248 0 0 0 0 0 0 0 0 0 0 0 0 0 0 0 0 
0 0 0 0 0 0 0 0 0 0 0 0 0 0 0 0 0 0 0 0 0 0 0 0 0 0 0 0 0 0 0 0 0 0 0 0 0 0 0 0 
0 0 0 0 0 0 0 0 0 0 0 0 0 0 0 0 0 0 0 0 0 0 0 0 0 0 0 0 0 0 0 0 0 0 0 0 0 0 0 0 
0 0 0 0 0 0 0 0 0 0 0 0 0 0 0 0 166 168 0 0 0 0 166 168 0 0 0 0 0 0 0 0 0 0 0 0 0 0 0 0 
166 168 0 0 0 0 166 168 166 167 167 167 167 167 167 168 206 208 0 0 0 0 206 208 166 167 167 167 167 167 167 167 167 167 167 167 167 167 167 167 
246 248 0 0 0 0 246 248 246 247 247 247 247 247 247 248 206 208 0 0 0 0 206 208 246 247 247 247 247 247 247 247 247 247 247 247 247 247 247 247 
0 0 0 0 0 0 0 0 0 0 0 0 0 0 0 0 246 248 0 0 0 0 246 248 0 0 0 0 0 0 0 0 0 0 0 0 0 0 0 0 
0 0 0 0 0 0 0 0 0 0 0 0 0 0 0 0 0 0 0 0 0 0 0 0 0 0 0 0 0 0 0 0 0 0 0 0 0 0 0 0 
0 0 0 0 0 0 0 0 0 0 0 0 0 0 0 0 0 0 0 0 0 0 0 0 0 0 0 0 0 0 0 0 0 0 0 0 0 0 0 0 
0 0 0 0 0 0 0 0 0 0 0 0 0 0 0 0 166 168 0 0 0 0 166 168 0 0 0 0 0 0 0 0 0 0 0 0 0 0 0 0 
167 167 167 167 167 167 167 167 167 167 167 167 167 167 167 168 206 208 0 0 0 0 206 208 166 167 167 167 167 167 167 168 166 168 0 0 0 0 166 168 
247 247 247 247 247 247 247 247 247 247 247 247 247 247 247 248 206 208 0 0 0 0 206 208 246 247 247 247 247 247 247 248 246 248 0 0 0 0 246 248 
0 0 0 0 0 0 0 0 0 0 0 0 0 0 0 0 246 248 0 0 0 0 246 248 0 0 0 0 0 0 0 0 0 0 0 0 0 0 0 0 
0 0 0 0 0 0 0 0 0 0 0 0 0 0 0 0 0 0 0 0 0 0 0 0 0 0 0 0 0 0 0 0 0 0 0 0 0 0 0 0 
0 0 0 0 0 0 0 0 0 0 0 0 0 0 0 0 0 0 0 0 0 0 0 0 0 0 0 0 0 0 0 0 0 0 0 0 0 0 0 0 
0 0 0 0 0 0 0 0 0 0 0 0 0 0 0 0 166 168 0 0 0 0 166 168 0 0 0 0 0 0 0 0 0 0 0 0 0 0 0 0 
166 168 0 0 0 0 166 168 166 167 167 167 167 167 167 168 206 208 0 0 0 0 206 208 166 167 167 167 167 167 167 167 167 167 167 167 167 167 167 167 
246 248 0 0 0 0 246 248 246 247 247 247 247 247 247 248 246 248 0 0 0 0 246 248 246 247 247 247 247 247 247 247 247 247 247 247 247 247 247 247 
0 0 0 0 0 0 0 0 0 0 0 0 0 0 0 0 0 0 0 0 0 0 0 0 0 0 0 0 0 0 0 0 0 0 0 0 0 0 0 0 
0 0 0 0 0 0 0 0 0 0 0 0 0 0 0 0 0 0 0 0 0 0 0 0 0 0 0 0 0 0 0 0 0 0 0 0 0 0 0 0 
0 0 0 0 0 0 0 0 0 0 0 0 0 0 0 0 0 0 0 0 0 0 0 0 0 0 0 0 0 0 0 0 0 0 0 0 0 0 0 0 
0 0 0 0 0 0 0 0 0 0 0 0 0 0 0 0 0 0 0 0 0 0 0 0 0 0 0 0 0 0 0 0 0 0 0 0 0 0 0 0 
167 167 167 167 167 167 167 167 167 167 167 167 167 167 167 167 167 167 167 167 167 167 167 167 167 167 167 167 167 167 167 167 167 167 167 167 167 167 167 167 
86 86 86 86 86 86 86 86 86 86 86 86 86 86 86 86 86 86 86 86 86 86 86 86 86 86 86 86 86 86 86 86 86 86 86 86 86 86 86 86 
9
19 25 10 1
31 6 1 3 5 -24 -24 344 256
19 6 1 3 5 -24 -24 344 256
19 12 1 2 5 -24 -24 344 256
7 12 1 2 5 -24 -24 344 256
13 18 1 3 5 -24 -24 344 256
25 18 1 3 5 -24 -24 344 256
35 2 9
3 25 10 0
