0 0 0 0 0 0 0 0 0 0 0 0 0 0 0 0 0 0 0 0 0 0 0 0 0 0 0 0 0 0 0 0 0 0 0 0 0 0 0 0 
0 0 0 0 0 0 0 0 0 0 0 0 0 0 0 0 0 0 0 0 0 0 0 0 0 0 0 0 0 0 0 0 0 0 0 0 0 0 0 0 
0 0 0 0 0 0 0 0 0 0 0 0 0 0 0 0 0 0 0 0 0 0 0 0 0 0 0 0 0 0 0 0 0 0 0 0 0 0 0 0 
0 0 0 0 0 0 0 0 0 0 0 0 0 0 0 0 0 0 0 0 0 0 0 0 0 0 0 0 0 0 0 0 0 0 0 0 0 0 0 0 
0 0 0 0 0 0 0 0 0 0 0 0 0 0 0 0 0 0 0 0 0 0 0 0 0 0 0 0 0 0 0 0 0 0 0 0 0 0 0 0 
0 0 0 0 0 0 0 0 0 0 0 0 0 0 0 0 0 0 0 0 0 0 0 0 0 0 0 0 0 0 0 0 0 0 0 0 0 0 0 0 
0 0 0 0 0 0 0 0 0 0 0 0 0 0 0 0 0 0 0 0 0 0 0 0 0 0 0 0 0 0 0 0 0 0 0 0 0 0 0 0 
0 0 0 0 0 0 0 0 0 0 0 0 0 0 0 0 169 170 170 170 170 170 170 171 0 0 0 0 0 0 0 0 0 0 0 0 0 0 0 0 
6 6 6 6 6 6 6 6 6 6 6 6 6 6 6 6 209 89 89 89 89 89 89 211 6 6 6 6 6 6 6 6 0 0 0 0 0 0 6 6 
170 170 170 170 170 170 170 170 171 169 170 170 170 170 170 171 209 89 89 89 89 89 89 211 169 170 170 170 170 170 170 171 0 0 0 0 0 0 169 170 
89 89 89 89 89 89 89 89 211 249 250 250 250 250 250 251 209 89 89 89 89 89 89 211 249 250 250 250 250 250 250 251 0 0 0 0 0 0 209 89 
89 89 89 89 89 89 89 89 211 7 7 7 7 7 7 7 209 89 89 89 89 89 89 211 7 7 7 7 7 7 7 7 0 0 0 0 0 0 209 89 
250 250 250 250 250 250 250 250 251 0 0 0 0 0 0 0 249 250 250 250 250 250 250 251 0 0 0 0 0 0 0 0 0 0 0 0 0 0 249 250 
0 0 0 0 0 0 0 0 0 0 0 0 0 0 0 0 0 0 0 0 0 0 0 0 0 0 0 0 0 0 0 0 0 0 0 0 0 0 0 0 
0 0 0 0 0 0 0 0 0 0 0 0 0 0 0 0 0 0 0 0 0 0 0 0 0 0 0 0 0 0 0 0 0 0 0 0 0 0 0 0 
0 0 0 0 0 0 0 0 0 0 0 0 0 0 0 0 0 0 0 0 0 0 0 0 0 0 0 0 0 0 0 0 0 0 0 0 0 0 0 0 
0 0 0 0 0 0 0 0 0 0 0 0 0 0 0 0 0 0 0 0 0 0 0 0 0 0 0 0 0 0 0 0 0 0 0 0 0 0 0 0 
0 0 0 0 0 0 0 0 0 0 169 170 170 170 170 170 171 0 0 0 0 0 0 0 0 0 0 0 0 0 0 169 170 170 170 170 170 170 171 0 
6 6 6 6 6 6 6 6 6 6 209 89 89 89 89 89 211 6 6 6 6 6 6 6 6 6 6 6 6 6 6 209 89 89 89 89 89 89 211 6 
170 171 169 170 170 170 170 170 170 171 209 89 89 89 89 89 211 169 170 170 170 170 170 170 170 170 170 170 170 170 171 209 89 89 89 89 89 89 211 169 
250 251 209 89 89 89 89 89 89 211 249 250 250 250 250 250 251 249 250 250 250 250 250 250 250 250 250 250 250 250 251 249 250 250 250 250 250 250 251 249 
7 7 209 89 89 89 89 89 89 211 7 7 7 7 7 7 7 7 7 7 7 7 7 7 7 7 7 7 7 7 7 7 7 7 7 7 7 7 7 7 
0 0 249 250 250 250 250 250 250 251 0 0 0 0 0 0 0 0 0 0 0 0 0 0 0 0 0 0 0 0 0 0 0 0 0 0 0 0 0 0 
0 0 0 0 0 0 0 0 0 0 0 0 0 0 0 0 0 0 0 0 0 0 0 0 0 0 0 0 0 0 0 0 0 0 0 0 0 0 0 0 
0 0 0 0 0 0 0 0 0 0 0 0 0 0 0 0 0 0 0 0 0 0 0 0 0 0 0 0 0 0 0 0 0 0 0 0 0 0 0 0 
0 0 0 0 0 0 0 0 0 0 0 0 0 0 0 0 0 0 0 0 0 0 0 0 0 0 0 0 0 0 0 0 0 0 0 0 0 0 0 0 
0 0 0 0 0 0 0 0 0 0 0 0 0 0 0 0 0 0 0 0 0 0 0 0 0 0 0 0 0 0 0 0 0 0 0 0 0 0 0 0 
0 0 0 0 0 0 0 0 0 0 0 0 0 0 0 0 0 0 0 0 0 0 0 0 0 0 0 0 0 0 0 0 0 0 0 0 0 0 0 0 
0 0 0 0 0 0 0 0 0 0 0 0 0 0 0 0 0 0 0 0 0 0 0 0 0 0 0 0 0 0 0 0 0 0 0 0 0 0 0 0 
2
19 14 9
17 5 10 1
