259 259 259 259 259 259 259 259 259 260 218 98 220 0 218 98 98 220 0 218 98 98 98 220 0 218 98 98 98 98 220 0 218 98 220 219 219 219 219 219 
0 0 0 0 0 0 0 0 0 0 218 98 220 0 218 98 98 220 0 218 98 98 98 220 0 218 98 98 98 98 220 0 218 98 220 219 219 219 219 219 
179 179 179 179 179 179 180 178 180 0 218 98 220 0 218 98 98 220 0 218 98 98 98 220 0 218 98 98 98 98 220 0 218 98 220 219 219 219 219 219 
259 259 259 259 259 259 260 218 220 0 218 98 220 0 218 98 98 220 0 218 98 98 98 220 0 218 98 98 98 98 220 0 218 98 220 219 219 219 219 219 
0 0 0 0 0 0 0 218 220 0 218 98 220 0 218 98 98 220 0 218 98 98 98 220 0 218 98 98 98 98 220 0 218 98 139 179 179 179 179 179 
179 179 180 178 179 180 0 218 220 0 258 259 260 0 218 98 98 220 0 258 259 259 259 260 0 218 98 98 98 98 220 0 218 98 98 98 98 98 98 98 
98 98 220 258 259 260 0 258 260 0 0 0 0 0 258 259 259 260 0 7 7 7 7 7 0 218 98 98 98 98 220 0 258 259 259 259 259 259 259 259 
98 98 220 0 0 0 0 0 0 0 0 0 0 0 0 0 0 0 0 0 0 0 0 0 0 258 259 259 259 259 260 0 7 7 7 7 7 7 7 7 
98 98 220 0 0 0 0 0 0 0 0 0 0 0 0 0 0 0 0 0 0 0 0 0 0 0 0 0 0 0 0 0 0 0 0 0 0 0 0 0 
98 98 220 0 0 0 0 0 0 0 0 0 0 0 0 0 0 0 0 0 0 0 0 0 0 0 0 0 0 0 0 0 0 0 0 0 0 0 0 0 
98 98 220 0 0 0 0 0 0 0 0 0 0 0 0 0 0 0 0 0 0 0 0 0 0 0 0 0 0 0 0 0 0 0 0 0 0 0 0 0 
98 98 220 0 0 0 0 0 0 0 0 0 0 0 0 0 0 0 0 0 0 0 0 0 0 0 0 0 0 0 0 0 0 0 0 0 0 0 0 0 
98 98 220 0 0 0 0 0 0 0 0 0 0 0 0 0 0 0 0 0 0 0 0 0 0 0 0 0 0 0 0 0 0 0 0 0 0 0 0 0 
98 98 220 0 0 0 0 0 0 0 0 0 0 0 0 0 0 0 0 0 0 0 0 0 0 0 0 0 0 0 0 0 0 0 0 0 0 0 0 0 
98 98 220 178 179 180 0 178 179 179 179 179 180 0 6 6 6 6 0 178 179 179 179 180 0 0 0 0 0 0 0 0 178 179 179 179 179 179 179 179 
259 259 260 258 259 260 0 218 98 98 98 98 220 0 178 179 179 180 0 218 98 98 98 220 0 6 6 6 6 6 6 0 218 98 98 98 98 98 98 98 
0 0 0 0 0 0 0 258 259 259 259 259 260 0 258 259 259 260 0 258 259 259 259 260 0 178 179 179 179 179 180 0 258 259 259 259 259 259 259 259 
179 179 179 179 179 179 179 179 180 0 0 0 0 0 0 0 0 0 0 0 0 0 0 0 0 258 259 259 259 259 260 0 0 0 0 0 0 0 0 0 
259 259 259 259 259 259 259 259 260 0 0 0 0 0 0 0 0 0 0 0 0 0 0 0 0 0 0 0 0 0 0 0 0 0 0 0 0 0 0 0 
0 0 0 0 0 0 0 0 0 0 0 0 0 0 0 0 0 0 0 0 0 0 0 0 0 0 0 0 0 0 0 0 0 0 0 0 0 0 0 0 
179 179 179 179 179 179 179 179 180 0 0 0 0 0 0 0 0 0 0 0 0 0 0 0 0 0 0 0 0 0 0 0 0 0 0 0 0 0 0 0 
259 259 259 259 259 259 259 259 260 0 0 0 0 0 0 0 0 0 0 0 0 0 0 0 0 0 0 0 0 0 0 0 0 0 0 0 0 0 0 0 
0 0 0 0 0 0 0 0 0 0 0 0 0 0 0 0 0 0 0 0 0 0 0 0 0 0 0 0 0 0 0 0 0 0 0 0 0 0 0 0 
179 179 179 179 179 179 179 179 179 179 179 179 180 0 178 179 179 180 0 178 179 179 179 180 0 178 179 179 179 179 180 0 0 0 0 0 0 0 0 0 
98 98 98 98 98 98 98 98 98 98 98 98 220 0 218 98 98 220 0 218 98 98 98 220 0 218 98 98 98 98 220 0 178 179 179 179 179 179 179 179 
259 259 259 259 259 259 259 259 259 259 100 98 220 0 218 98 98 220 0 218 98 98 98 220 0 218 98 98 98 98 220 0 218 98 98 98 98 98 98 98 
219 219 219 219 219 219 219 219 219 219 218 98 220 0 218 98 98 220 0 218 98 98 98 220 0 218 98 98 98 98 220 0 218 98 99 259 259 259 259 259 
219 219 219 219 219 219 219 219 219 219 218 98 220 0 218 98 98 220 0 218 98 98 98 220 0 218 98 98 98 98 220 0 218 98 220 219 219 219 219 219 
219 219 219 219 219 219 219 219 219 219 218 98 220 0 218 98 98 220 0 218 98 98 98 220 0 218 98 98 98 98 220 0 218 98 220 219 219 219 219 219 
1
20 12 10 1
