98 98 98 98 98 98 98 98 98 98 98 98 98 98 98 98 98 98 98 98 98 98 98 98 98 98 98 98 98 98 98 98 98 98 98 98 98 98 98 98 
259 259 259 259 259 259 259 259 259 259 259 259 259 259 259 259 259 259 259 259 259 259 259 259 259 259 259 259 259 259 259 259 259 259 259 259 259 259 259 259 
0 0 0 0 0 0 0 0 0 0 0 0 0 0 0 0 0 0 0 0 0 0 0 0 0 0 0 0 0 0 0 0 0 0 0 0 0 0 0 0 
0 0 0 0 0 0 0 0 0 0 0 0 0 0 0 0 0 0 0 0 0 0 0 0 0 0 0 0 0 0 0 0 0 0 0 0 0 0 0 0 
0 0 0 0 0 0 0 0 0 0 0 0 0 0 0 0 0 0 0 0 0 0 0 0 0 0 0 0 0 0 0 0 0 0 0 0 0 0 0 0 
0 0 0 0 0 0 0 0 0 0 0 0 0 0 0 0 0 0 0 0 0 0 0 0 0 0 0 0 0 0 0 0 0 0 0 0 0 0 0 0 
0 0 0 0 0 0 0 0 0 0 0 0 0 0 0 0 0 0 0 0 0 178 179 179 179 179 179 179 179 179 179 179 179 179 179 179 179 179 179 179 
0 0 0 0 0 0 0 0 0 0 0 0 0 0 0 0 0 178 179 179 180 218 98 98 98 98 98 98 98 98 98 98 98 98 98 98 98 98 98 98 
179 179 179 179 179 179 179 179 179 179 179 179 179 179 179 179 180 218 98 98 220 218 98 99 259 259 259 259 259 259 259 259 259 259 259 259 259 259 259 259 
98 98 98 98 98 98 98 98 98 98 98 98 98 98 98 98 220 218 98 98 220 218 98 220 219 219 219 219 219 219 219 219 219 219 219 219 219 219 219 219 
259 259 259 259 259 259 259 259 259 259 259 259 259 259 100 98 220 218 98 98 220 218 98 220 219 219 219 219 219 219 219 219 219 219 219 219 219 219 219 219 
219 219 219 219 219 219 219 219 219 219 219 219 219 219 218 98 220 218 98 98 220 218 98 220 219 219 219 219 219 219 219 219 219 219 219 219 219 219 219 219 
219 219 219 219 219 219 219 219 219 219 219 219 219 219 218 98 220 218 98 98 220 218 98 220 219 219 219 219 219 219 219 219 219 219 219 219 219 219 219 219 
219 219 219 219 219 219 219 219 219 219 219 219 219 219 218 98 220 218 98 98 220 218 98 220 219 219 219 219 219 219 219 219 219 219 219 219 219 219 219 219 
219 219 219 219 219 219 219 219 219 219 219 219 219 219 218 98 220 218 98 98 220 218 98 220 219 219 219 219 219 219 219 219 219 219 219 219 219 219 219 219 
219 219 219 219 219 219 219 219 219 219 219 219 219 219 218 98 220 218 98 98 220 218 98 220 219 219 219 219 219 219 219 219 219 219 219 219 219 219 219 219 
179 179 179 179 179 179 179 179 179 179 179 179 179 179 140 98 220 258 259 259 260 218 98 220 219 219 219 219 219 219 219 219 219 219 219 219 219 219 219 219 
98 98 98 98 98 98 98 98 98 98 98 98 98 98 98 98 220 0 0 0 0 218 98 220 219 219 219 219 219 219 219 219 219 219 219 219 219 219 219 219 
259 259 259 259 259 259 259 259 259 259 259 259 259 259 259 259 260 0 0 0 0 218 98 220 219 219 219 219 219 219 219 219 219 219 219 219 219 219 219 219 
0 0 0 0 0 0 0 0 0 0 0 0 0 0 0 0 0 0 0 0 0 218 98 139 179 179 179 179 179 179 179 179 179 179 179 179 179 179 179 179 
0 0 0 0 0 0 0 0 0 0 0 0 0 0 0 0 0 0 0 0 0 218 98 98 98 98 98 98 98 98 98 98 98 98 98 98 98 98 98 98 
0 0 0 0 0 0 0 0 0 0 0 0 0 0 0 0 0 0 0 0 0 258 259 259 259 259 259 259 259 259 259 259 259 259 259 259 259 259 259 259 
0 0 0 0 0 0 0 0 0 0 0 0 0 0 0 0 0 0 0 0 0 0 0 0 0 0 0 0 0 0 0 0 0 0 0 0 0 0 0 0 
0 0 0 0 0 0 0 0 0 0 0 0 0 0 0 0 0 0 0 0 0 0 0 0 0 0 0 0 0 0 0 0 0 0 0 0 0 0 0 0 
0 0 0 0 0 0 0 0 0 0 0 0 0 0 0 0 0 0 0 0 0 0 0 0 0 0 0 0 0 0 0 0 0 0 0 0 0 0 0 0 
179 179 179 179 179 179 179 179 179 179 179 179 179 179 179 180 0 0 0 0 0 0 0 0 0 0 0 0 0 0 0 0 0 0 0 0 0 0 0 0 
98 98 98 98 98 98 98 98 98 98 98 98 98 98 98 220 178 179 179 179 179 179 179 179 179 179 179 179 179 179 179 179 179 179 179 179 179 179 179 179 
259 259 259 259 259 259 259 259 259 259 259 259 259 100 98 220 218 98 98 98 98 98 98 98 98 98 98 98 98 98 98 98 98 98 98 98 98 98 98 98 
219 219 219 219 219 219 219 219 219 219 219 219 219 218 98 220 218 98 99 259 259 259 259 259 259 259 259 259 259 259 259 259 259 259 259 259 259 259 259 259 
1
18 5 10 1
