98 98 98 98 98 98 98 98 98 98 98 98 98 98 98 98 98 98 98 98 98 98 98 98 98 98 98 98 98 98 98 220 218 98 220 219 219 219 219 219 
259 259 259 259 259 259 259 259 259 259 259 259 259 259 259 259 259 259 259 259 259 259 259 259 259 259 259 259 259 259 259 260 218 98 220 219 219 219 219 219 
0 0 0 0 0 0 0 0 0 0 0 0 0 0 0 0 0 0 0 0 0 0 0 0 0 0 0 0 0 0 0 0 218 98 220 219 219 219 219 219 
0 0 0 0 0 0 0 0 0 0 0 0 0 0 0 0 0 0 0 0 0 0 0 0 0 0 0 0 0 0 0 0 218 98 220 219 219 219 219 219 
0 0 0 0 0 0 0 0 0 0 0 0 0 0 0 0 0 0 0 0 0 0 0 0 0 0 0 0 0 0 0 0 218 98 220 219 219 219 219 219 
0 0 0 0 0 0 0 0 0 0 0 0 0 0 0 0 0 0 0 0 0 0 0 0 0 0 0 0 0 0 0 0 218 98 220 219 219 219 219 219 
179 179 179 179 179 179 179 180 178 179 179 179 179 179 179 179 179 179 179 179 179 179 179 179 179 179 179 180 0 0 0 0 218 98 220 219 219 219 219 219 
98 98 98 98 98 98 98 220 258 259 259 259 259 259 259 259 259 259 259 259 259 259 259 259 259 259 259 260 0 0 0 0 218 98 220 219 219 219 219 219 
259 259 259 259 259 100 98 220 0 0 0 0 0 0 0 0 0 0 0 0 0 0 0 0 0 0 0 0 0 0 0 0 218 98 220 219 219 219 219 219 
219 219 219 219 219 218 98 220 0 0 0 0 0 0 0 0 0 0 0 0 0 0 0 0 0 0 0 0 0 0 0 0 218 98 220 219 219 219 219 219 
219 219 219 219 219 218 98 220 0 0 0 0 0 0 0 0 0 0 0 0 0 0 0 0 0 0 0 0 0 0 0 0 218 98 139 179 179 179 179 179 
219 219 219 219 219 218 98 220 0 0 0 0 178 179 179 179 179 179 179 179 179 179 179 179 179 179 179 179 179 179 179 180 218 98 98 98 98 98 98 98 
219 219 219 219 219 218 98 220 0 0 0 0 258 259 259 259 259 259 259 259 259 259 259 259 259 259 259 259 259 259 259 260 258 259 259 259 259 259 259 259 
219 219 219 219 219 218 98 220 0 0 0 0 0 0 0 0 0 0 0 0 0 0 0 0 0 0 0 0 0 0 0 0 0 0 0 0 0 0 0 0 
219 219 219 219 219 218 98 220 0 0 0 0 0 0 0 0 0 0 0 0 0 0 0 0 0 0 0 0 0 0 0 0 0 0 0 0 0 0 0 0 
219 219 219 219 219 218 98 220 0 0 0 0 0 0 0 0 0 0 0 0 0 0 0 0 0 0 0 0 0 0 0 0 0 0 0 0 0 0 0 0 
219 219 219 219 219 218 98 220 178 179 179 180 178 179 179 180 178 179 179 179 179 179 179 180 178 179 179 180 178 179 179 179 180 0 0 0 0 0 0 0 
219 219 219 219 219 218 98 220 218 98 98 220 258 259 259 260 218 98 98 98 98 98 98 220 258 259 259 260 218 98 98 98 220 0 0 0 0 0 0 0 
219 219 219 219 219 218 98 220 218 98 98 220 0 0 0 0 218 98 98 98 98 98 98 220 0 0 0 0 218 98 98 98 220 178 179 179 179 179 179 179 
179 179 179 179 179 140 98 220 218 98 98 220 0 0 0 0 218 98 98 98 98 98 98 220 0 0 0 0 218 98 98 98 220 218 98 98 98 98 98 98 
98 98 98 98 98 98 98 220 218 98 98 220 0 0 0 0 258 259 259 259 259 259 259 260 0 0 0 0 218 98 98 98 220 218 98 98 98 98 98 98 
259 259 259 259 259 259 259 260 218 98 98 220 0 0 0 0 0 0 0 0 0 0 0 0 0 0 0 0 218 98 98 98 220 258 259 259 259 259 259 259 
0 0 0 0 0 0 0 0 258 259 259 260 0 0 0 0 0 0 0 0 0 0 0 0 0 0 0 0 258 259 259 259 260 0 0 0 0 0 0 0 
0 0 0 0 0 0 0 0 0 0 0 0 0 0 0 0 0 0 0 0 0 0 0 0 0 0 0 0 0 0 0 0 0 0 0 0 0 0 0 0 
0 0 0 0 0 0 0 0 0 0 0 0 0 0 0 0 0 0 0 0 0 0 0 0 0 0 0 0 0 0 0 0 0 0 0 0 0 0 0 0 
0 0 0 0 0 0 0 0 0 0 0 0 0 0 0 0 0 0 0 0 0 0 0 0 0 0 0 0 0 0 0 0 0 0 0 0 0 0 0 0 
179 179 179 179 179 179 179 179 179 179 179 179 179 179 179 179 179 179 179 179 179 179 179 179 179 179 179 179 179 179 179 179 179 179 179 179 179 179 179 179 
98 98 98 98 98 98 98 98 98 98 98 98 98 98 98 98 98 98 98 98 98 98 98 98 98 98 98 98 98 98 98 98 98 98 98 98 98 98 98 98 
259 259 259 259 259 259 259 259 259 259 259 259 259 259 259 259 259 259 259 259 259 259 259 259 259 259 259 259 259 259 259 259 259 259 259 259 259 259 259 259 
2
13 19 1 0 3 0 0 320 240
25 19 1 0 3 0 0 320 240
