204 204 204 204 204 204 204 204 204 204 204 204 204 203 83 205 203 83 205 204 204 203 83 205 0 0 0 0 203 83 205 204 204 204 204 204 204 204 204 204 
204 204 204 204 204 204 204 204 204 204 204 204 204 203 83 205 203 83 205 204 204 203 83 205 0 0 0 0 203 83 205 204 204 204 204 204 204 204 204 204 
204 204 204 204 204 204 204 204 204 204 204 204 204 203 83 205 203 83 205 204 204 203 83 205 0 0 0 0 203 83 205 204 204 204 204 204 204 204 204 204 
164 164 164 164 164 164 164 164 164 164 164 164 164 125 83 205 203 83 205 204 204 203 83 205 0 0 0 0 203 83 124 164 164 164 164 164 164 164 164 164 
83 83 83 83 83 83 83 83 83 83 83 83 83 83 83 205 203 83 205 204 204 203 83 205 0 0 0 0 203 83 83 83 83 83 83 83 83 83 83 83 
244 244 244 244 244 244 244 244 244 244 244 244 244 244 244 245 203 83 205 204 204 203 83 205 0 0 0 0 243 244 244 244 244 244 244 244 244 244 244 244 
0 0 0 0 0 0 0 0 0 0 0 0 0 0 0 0 203 83 205 204 204 203 83 205 0 0 0 0 0 0 0 0 0 0 0 0 0 0 0 0 
0 0 0 0 0 0 0 0 0 0 0 0 0 0 0 0 203 83 205 204 204 203 83 205 0 0 0 0 0 0 0 0 0 0 0 0 0 0 0 0 
0 0 0 0 0 0 0 0 0 0 0 0 0 0 0 0 203 83 205 204 204 203 83 205 0 0 0 0 0 0 0 0 0 0 0 0 0 0 0 0 
0 0 0 0 0 0 0 0 0 0 0 0 0 0 0 0 203 83 124 164 164 125 83 205 0 0 0 0 0 0 0 0 0 0 0 0 0 0 0 0 
0 0 0 0 0 0 0 0 0 0 0 0 0 0 0 0 203 83 83 83 83 83 83 205 0 0 0 0 0 0 0 0 0 0 0 0 0 0 0 0 
0 0 0 0 0 0 0 0 0 0 0 0 0 0 0 0 243 244 244 244 244 244 244 245 0 0 0 0 0 0 0 0 0 0 0 0 0 0 0 0 
164 164 164 164 164 164 164 164 165 163 164 165 0 0 0 0 163 164 164 165 163 164 164 164 164 164 164 164 164 164 164 164 164 164 164 164 164 164 164 164 
83 83 83 83 83 83 83 83 205 203 83 205 0 0 0 0 203 83 83 205 203 83 83 83 83 83 83 83 83 83 83 83 83 83 83 83 83 83 83 83 
244 244 244 244 244 244 244 244 245 243 244 245 0 0 0 0 203 83 83 205 243 244 244 244 244 244 244 244 244 244 244 244 244 244 244 244 244 244 244 244 
0 0 0 0 0 0 0 0 0 0 0 0 0 0 0 0 203 83 83 205 0 0 0 0 0 0 0 0 0 0 0 0 0 0 0 0 0 0 0 0 
0 0 0 0 0 0 0 0 0 0 0 0 0 0 0 0 203 83 83 205 0 0 0 0 0 0 0 0 0 0 0 0 0 0 0 0 0 0 0 0 
0 0 0 0 0 0 0 0 0 0 0 0 0 0 0 0 243 244 244 245 0 0 0 0 0 0 0 0 0 0 0 0 0 0 0 0 0 0 0 0 
0 0 0 0 0 0 0 0 0 0 0 0 0 0 0 0 163 164 164 165 0 0 0 0 0 0 0 0 0 0 0 0 0 0 0 0 0 0 0 0 
0 0 0 0 0 0 0 0 0 0 0 0 0 0 0 0 203 83 83 205 0 0 0 0 0 0 0 0 0 0 0 0 0 0 0 0 0 0 0 0 
0 0 0 0 0 0 0 0 0 0 0 0 0 0 0 0 203 83 83 205 0 0 0 0 0 0 0 0 0 0 0 0 0 0 0 0 0 0 0 0 
164 164 164 164 164 164 164 164 164 164 164 165 163 164 164 165 203 83 83 205 0 0 0 0 163 164 164 164 164 164 164 164 164 164 164 164 164 164 164 164 
83 83 83 83 83 83 83 83 83 83 83 205 243 244 244 245 243 244 244 245 0 0 0 0 203 83 83 83 83 83 83 83 83 83 83 83 83 83 83 83 
244 244 244 244 244 244 244 244 244 85 83 205 0 0 0 0 0 0 0 0 0 0 0 0 203 83 84 244 244 244 244 244 244 244 244 244 244 244 244 244 
204 204 204 204 204 204 204 204 204 203 83 205 0 0 0 0 0 0 0 0 0 0 0 0 203 83 205 204 204 204 204 204 204 204 204 204 204 204 204 204 
204 204 204 204 204 204 204 204 204 203 83 205 0 0 0 0 0 0 0 0 0 0 0 0 203 83 205 204 204 204 204 204 204 204 204 204 204 204 204 204 
204 204 204 204 204 204 204 204 204 203 83 205 0 0 0 0 0 0 0 0 0 0 0 0 203 83 205 204 204 204 204 204 204 204 204 204 204 204 204 204 
204 204 204 204 204 204 204 204 204 203 83 205 0 0 0 0 163 164 164 164 164 164 164 165 203 83 205 204 204 204 204 204 204 204 204 204 204 204 204 204 
204 204 204 204 204 204 204 204 204 203 83 205 0 0 0 0 203 83 83 83 83 83 83 205 203 83 205 204 204 204 204 204 204 204 204 204 204 204 204 204 
1
13 19 10 1
