489 489 489 489 489 489 489 489 489 489 489 489 489 489 489 489 611 0 0 0 0 0 0 0 0 0 0 0 0 0 0 0 0 0 0 0 0 0 0 0 
489 489 489 489 489 489 489 489 489 489 489 489 489 489 489 489 611 0 0 0 0 0 0 0 0 0 0 0 0 0 0 0 0 0 0 0 0 0 0 0 
489 489 489 489 489 489 489 489 489 489 489 489 489 489 489 489 611 0 0 0 0 0 0 0 0 0 0 0 0 0 0 0 0 0 0 0 0 0 0 0 
489 489 489 489 489 489 489 489 489 489 489 489 489 489 489 489 611 0 0 0 0 0 0 0 0 0 0 0 0 0 0 0 0 0 0 0 0 0 0 0 
489 489 489 489 489 489 489 489 489 489 489 489 489 489 489 490 651 0 0 0 0 0 0 0 0 0 0 0 0 0 0 0 0 0 0 0 0 0 0 0 
489 489 489 489 489 489 489 489 489 489 489 489 489 489 489 611 0 0 0 0 0 0 0 0 0 0 0 0 0 0 0 0 0 0 0 0 0 0 0 0 
489 489 489 489 489 489 489 489 489 489 489 489 489 489 489 611 0 0 0 0 0 0 0 0 0 0 0 0 0 0 0 0 0 0 0 0 0 0 0 0 
489 489 489 489 489 489 489 489 489 489 489 489 489 489 489 611 129 129 129 129 129 129 129 129 129 0 0 0 0 0 0 0 0 0 0 0 0 0 0 0 
489 489 489 489 489 489 489 489 489 489 489 489 489 489 490 651 0 0 0 0 0 0 0 0 129 0 0 0 0 0 0 0 0 0 0 0 0 0 569 570 
489 489 489 489 489 489 489 489 489 489 489 489 489 489 611 0 0 0 0 0 0 0 0 0 129 0 0 0 0 0 0 0 0 0 0 569 570 570 531 489 
650 650 650 650 650 650 650 650 650 650 491 489 489 489 611 0 0 0 0 0 0 0 0 0 129 0 0 0 0 0 0 0 0 569 570 531 489 489 489 489 
0 0 0 0 0 0 0 0 0 0 649 650 650 650 651 0 0 0 0 0 0 0 0 0 129 0 0 0 0 0 0 0 0 609 489 489 489 489 489 489 
0 0 0 0 0 0 0 0 0 0 0 0 689 0 0 0 0 0 0 0 0 0 0 569 570 570 570 570 570 570 570 570 570 531 489 489 489 489 489 489 
0 0 0 0 0 0 0 0 0 0 0 0 689 0 0 0 0 0 0 569 570 570 570 531 489 489 489 489 489 489 489 489 489 489 489 489 489 489 489 489 
0 0 0 0 0 0 0 0 0 0 0 0 689 0 0 0 0 0 0 609 489 489 489 489 489 489 489 489 489 489 489 489 489 489 489 489 489 489 489 489 
0 0 0 0 0 0 0 0 0 0 0 0 689 0 0 0 0 0 0 609 489 489 489 489 489 489 489 489 489 489 489 489 489 489 489 489 489 489 489 489 
0 0 0 0 0 0 0 0 0 0 0 0 689 0 0 0 0 0 0 609 489 489 489 489 489 489 489 489 489 489 489 489 489 489 489 489 489 489 489 489 
0 0 0 0 0 0 0 0 0 0 0 0 689 0 0 0 0 0 0 609 489 489 489 489 489 489 489 489 489 489 489 489 489 489 489 489 489 489 489 489 
0 0 0 0 0 0 0 0 0 0 0 0 689 0 0 0 0 0 0 609 489 489 489 489 489 489 489 489 489 489 489 489 489 489 489 489 489 489 489 489 
690 690 690 690 690 690 690 690 690 690 690 690 691 690 690 690 690 690 690 609 489 489 489 489 489 489 489 489 489 489 489 489 489 489 489 489 489 489 489 489 
0 0 0 0 0 0 0 0 0 0 0 0 689 0 0 0 0 0 0 609 489 489 489 489 489 489 489 489 489 489 489 489 489 489 489 489 489 489 489 489 
0 0 0 0 0 0 0 0 0 0 0 0 689 0 0 0 0 0 0 649 491 489 489 489 489 489 489 489 489 489 489 489 489 489 489 489 489 489 489 489 
0 0 0 0 0 0 0 0 0 0 0 0 689 0 0 0 0 0 0 0 609 489 489 489 489 489 489 489 489 489 489 489 489 489 489 489 489 489 489 489 
0 0 0 0 0 0 0 0 0 0 0 0 689 0 0 0 0 0 0 0 609 489 489 489 489 489 489 489 489 489 489 489 489 489 489 489 489 489 489 489 
0 0 0 0 0 0 0 0 0 0 0 0 689 0 0 0 0 0 0 0 609 489 489 489 489 489 489 489 489 489 489 489 489 489 489 489 489 489 489 489 
0 0 0 0 0 0 0 0 0 0 0 0 689 0 0 0 0 0 0 0 609 489 489 489 489 489 489 489 489 489 489 489 489 489 489 489 489 489 489 489 
0 0 0 0 0 0 0 0 0 0 0 0 689 0 0 0 0 0 0 0 609 489 489 489 489 489 489 489 489 489 489 489 489 489 489 489 489 489 489 489 
0 0 0 0 0 0 0 0 0 0 0 0 689 0 0 0 0 0 0 0 609 489 489 489 489 489 489 489 489 489 489 489 489 489 489 489 489 489 489 489 
0 0 0 0 0 0 0 0 0 0 0 0 689 0 0 0 0 0 0 0 609 489 489 489 489 489 489 489 489 489 489 489 489 489 489 489 489 489 489 489 
0
