0 0 0 0 0 0 0 0 0 0 0 0 686 0 0 0 0 0 0 0 606 486 486 486 486 486 486 486 486 486 486 486 486 486 486 486 486 486 486 486 
0 0 0 0 0 0 0 0 0 0 0 0 686 0 0 0 0 0 0 0 606 486 486 486 486 486 486 486 486 486 486 486 486 486 486 486 486 486 486 486 
0 0 0 0 0 0 0 0 0 0 0 0 686 0 0 0 0 0 0 0 606 486 486 486 486 486 486 486 486 486 486 486 486 486 486 486 486 486 486 486 
0 0 0 0 0 0 0 0 0 0 0 0 686 0 0 0 0 0 0 0 606 486 486 486 486 486 486 486 486 486 486 486 486 486 486 486 486 486 486 486 
0 0 0 0 0 0 0 0 0 0 0 0 686 0 0 0 0 0 0 0 606 486 486 486 486 486 486 486 486 486 486 486 486 486 486 486 486 486 486 486 
0 0 0 0 0 0 0 0 0 0 0 0 686 0 0 0 0 0 0 0 646 488 486 486 486 486 486 486 486 486 486 486 486 486 486 486 486 486 486 486 
0 0 0 0 0 0 0 0 0 0 0 0 686 0 0 0 0 0 0 0 0 606 486 486 486 486 486 486 486 486 486 486 486 486 486 486 486 486 486 486 
0 0 0 0 0 0 0 0 0 0 0 0 686 0 0 0 0 0 0 0 0 606 486 486 486 486 486 486 486 486 486 486 486 486 486 486 486 486 486 486 
0 0 0 0 0 0 0 0 0 0 0 0 686 0 0 0 0 0 0 0 0 606 486 486 486 486 486 486 486 486 486 486 486 486 486 486 486 486 486 486 
0 0 0 0 0 0 0 0 0 0 0 0 686 0 0 0 0 0 0 0 0 646 488 486 486 486 486 486 486 486 486 486 486 486 486 486 486 486 486 486 
0 0 0 0 0 0 0 0 0 0 0 0 686 0 0 0 0 0 0 0 0 0 606 486 486 486 486 486 486 486 486 486 486 486 486 486 486 486 486 486 
0 0 0 0 0 0 0 0 0 0 0 0 686 0 0 0 0 0 0 0 0 0 606 486 486 486 486 486 486 486 486 486 486 486 486 486 486 486 486 486 
0 0 0 0 0 0 0 0 0 0 0 0 686 0 0 0 0 0 0 0 0 0 606 486 486 486 486 486 486 486 486 486 486 486 486 486 486 486 486 486 
0 0 0 0 0 0 0 0 0 0 0 0 686 0 0 0 0 0 0 0 0 0 606 486 486 486 486 486 486 486 486 486 486 486 486 486 486 486 486 486 
687 687 687 687 687 687 687 687 687 687 687 687 688 687 687 687 687 687 687 687 687 687 606 486 486 486 486 486 486 486 486 486 486 486 486 486 486 486 486 486 
0 0 0 0 0 0 0 0 0 0 0 0 686 0 0 0 0 0 0 0 0 0 606 486 486 486 486 486 486 486 486 486 486 486 486 486 486 486 486 486 
0 0 0 0 0 0 0 0 0 0 0 0 686 0 0 0 0 0 0 0 0 0 646 488 486 486 486 486 486 486 486 486 486 486 486 486 486 486 486 486 
0 0 0 0 0 0 0 0 0 0 0 0 686 0 0 0 0 0 0 0 0 0 0 606 486 486 486 486 486 486 486 486 486 486 486 486 486 486 486 486 
0 0 0 0 0 0 0 0 0 0 0 0 686 0 0 0 0 0 0 0 0 0 0 606 486 486 486 486 486 486 486 486 486 486 486 486 486 486 486 486 
0 0 0 0 0 0 0 0 0 0 0 0 686 0 0 0 0 0 0 0 0 0 0 646 488 486 486 486 486 486 486 486 486 486 486 486 486 486 486 486 
0 0 0 0 0 0 0 0 0 0 0 0 686 0 0 0 0 0 0 0 0 0 0 0 606 486 486 486 486 486 486 486 486 486 486 486 486 486 486 486 
0 0 0 0 0 0 0 0 0 0 0 0 686 0 0 0 0 0 0 0 0 0 0 0 646 647 488 486 486 486 486 486 486 486 486 486 486 486 486 486 
0 0 0 0 0 0 0 0 0 0 0 0 686 0 0 0 0 0 0 0 0 0 0 0 0 0 646 647 647 647 488 486 486 486 486 486 486 486 486 486 
0 0 0 0 0 0 0 0 0 0 0 0 686 0 0 0 0 0 0 0 0 0 0 0 0 0 0 0 0 0 646 647 647 647 647 647 647 647 647 647 
0 0 0 0 0 0 0 0 0 0 0 0 686 0 0 0 0 0 0 0 0 0 0 0 0 0 0 0 0 0 0 0 0 0 0 0 0 0 0 0 
0 0 0 0 0 0 0 0 0 0 0 0 686 0 0 0 0 0 0 0 0 0 0 0 0 0 0 0 0 0 0 0 0 0 0 0 0 0 0 0 
0 0 0 0 0 0 0 0 0 0 0 0 686 0 0 0 0 0 0 0 0 0 0 0 0 0 0 0 0 0 0 0 0 0 0 0 0 0 0 0 
0 0 0 0 0 0 0 0 0 0 0 0 686 0 0 0 0 0 0 0 0 0 0 0 0 0 0 0 0 0 0 0 0 0 0 0 0 0 0 0 
0 0 0 0 0 0 0 0 0 0 0 0 686 0 0 0 0 0 0 0 0 0 0 0 0 0 0 0 0 0 0 0 0 0 0 0 0 0 0 0 
0
