283 283 283 284 444 444 444 444 444 444 444 444 444 444 444 444 444 444 444 444 444 444 444 444 444 444 444 444 444 444 444 444 444 444 444 444 444 444 444 444 
283 283 284 445 66 66 66 66 66 66 66 66 66 66 66 66 66 66 66 66 66 66 66 66 66 66 66 66 66 66 66 66 66 66 66 66 66 66 66 66 
283 283 405 53 0 0 0 0 0 0 0 0 0 0 0 0 0 0 0 0 0 0 0 0 0 0 0 0 0 0 0 0 0 0 0 0 0 0 0 0 
283 283 405 53 0 0 0 0 0 0 0 0 0 0 0 0 0 0 0 0 0 0 0 0 0 0 0 0 0 0 0 0 0 0 0 0 0 0 0 0 
283 283 405 53 0 0 0 0 0 0 0 0 0 0 0 0 0 0 0 0 0 0 0 0 0 0 0 0 0 0 0 0 0 0 0 0 0 0 0 0 
283 283 405 53 0 0 0 0 0 0 0 0 0 0 0 0 0 0 0 0 0 0 0 0 0 0 0 0 0 0 0 0 0 0 0 0 0 0 0 0 
283 283 405 53 0 0 0 0 0 0 0 0 0 0 0 0 0 0 0 0 0 0 0 0 0 0 0 0 0 0 0 0 0 0 0 0 0 0 0 0 
283 283 405 53 0 0 0 0 0 0 0 0 0 0 0 0 0 0 0 0 0 0 0 0 0 0 0 0 0 0 0 0 0 0 0 0 0 0 0 0 
283 283 405 53 0 0 0 0 0 0 0 0 0 0 0 0 0 0 0 0 0 0 0 0 0 0 0 0 0 0 0 0 0 0 0 0 0 0 0 0 
283 283 405 53 0 0 0 0 0 0 0 0 0 0 0 0 0 0 0 0 0 0 0 0 0 0 0 0 0 0 0 0 0 0 0 0 0 0 0 0 
283 283 405 53 0 0 0 0 0 0 0 0 0 0 0 0 0 0 0 0 0 0 0 0 0 0 0 0 0 0 0 0 0 0 0 0 0 0 0 0 
283 283 405 53 0 0 0 0 0 363 364 364 364 364 365 0 0 0 0 0 0 0 0 0 0 0 0 0 0 0 0 0 0 0 0 0 0 363 364 364 
283 283 405 53 0 0 0 0 54 403 283 283 283 283 405 53 0 0 0 0 0 0 0 0 0 0 0 0 0 0 0 0 0 0 0 0 54 403 283 283 
283 283 405 53 0 0 0 0 0 443 444 444 444 444 445 0 0 0 0 0 0 0 0 0 0 0 0 0 0 0 0 0 0 0 0 0 54 403 283 283 
283 283 405 53 0 0 0 0 0 0 0 0 0 0 0 0 0 0 0 0 0 0 0 0 0 0 0 0 0 0 0 0 0 0 0 0 54 403 283 283 
283 283 405 53 0 0 0 0 0 0 0 0 0 0 0 0 0 0 0 0 0 0 0 0 0 0 0 0 0 0 0 0 0 0 0 0 54 403 283 283 
283 283 405 53 0 0 0 0 0 0 0 0 0 0 0 0 0 0 0 0 0 0 0 0 0 0 0 0 0 0 0 0 0 0 0 0 54 403 283 283 
283 283 405 53 0 0 0 0 0 0 0 0 0 0 0 0 0 0 0 0 0 0 0 0 0 0 0 0 0 0 0 0 0 0 0 0 54 403 283 283 
283 283 405 53 0 0 0 0 0 0 0 0 0 0 0 0 0 0 0 0 0 0 0 0 0 0 0 0 0 0 0 0 0 0 0 0 54 403 283 283 
283 283 405 53 0 0 0 0 0 0 0 0 0 0 0 0 0 0 0 0 0 0 0 0 0 0 0 0 0 0 0 0 0 0 0 0 54 403 283 283 
283 283 405 53 0 0 0 0 0 0 0 0 0 0 0 0 0 0 0 0 0 0 0 0 0 0 0 0 0 0 0 0 0 0 0 0 54 403 283 283 
283 283 405 53 0 0 0 0 0 0 0 0 0 0 0 0 0 0 0 65 65 0 0 0 0 0 0 0 0 0 0 0 0 0 0 0 54 403 283 283 
283 283 405 53 0 0 0 0 0 0 0 0 0 0 0 0 0 0 54 363 365 53 0 0 0 0 0 0 0 0 0 0 0 0 0 0 54 403 283 283 
283 283 405 53 0 0 0 0 0 0 0 0 0 0 0 0 0 0 54 403 405 53 0 0 0 0 0 0 0 0 0 0 0 0 0 0 54 403 283 283 
283 283 405 53 0 0 0 0 0 0 0 0 0 0 0 0 0 0 54 403 405 53 0 0 0 0 0 0 0 0 0 0 0 0 0 0 54 403 283 283 
283 283 405 53 0 0 0 0 0 0 0 0 0 0 0 0 0 0 54 403 405 53 0 0 0 0 0 0 0 0 0 0 0 0 0 0 54 403 283 283 
283 283 405 53 0 0 0 0 0 0 0 0 0 0 0 0 0 0 54 403 405 53 0 0 0 0 0 0 0 0 0 0 0 0 0 0 54 403 283 283 
283 283 324 365 65 65 65 65 65 65 65 65 65 65 65 65 65 65 363 325 405 53 0 0 0 0 0 0 0 0 0 0 0 0 0 0 54 403 283 283 
283 283 283 324 364 364 364 364 364 364 364 364 364 364 364 364 364 364 325 283 405 53 0 0 0 0 0 0 0 0 0 0 0 0 0 0 54 403 283 283 
4
4 3 11 296
4 24 11 112
16 12 11 160
11 14 10 0
