498 498 498 498 498 498 498 498 498 498 498 498 498 498 498 498 498 498 498 498 498 498 498 498 498 498 498 498 498 498 498 498 498 498 620 0 0 0 0 0 
498 498 498 498 498 498 498 498 498 498 498 498 498 498 498 498 498 498 498 498 498 498 498 498 498 498 498 498 498 498 498 498 498 498 620 0 0 0 0 0 
498 498 498 498 498 498 498 498 498 498 498 498 498 498 498 498 498 498 498 498 498 498 498 498 498 498 498 498 498 498 498 498 498 498 620 0 0 0 0 0 
498 498 498 498 498 498 498 498 498 498 498 498 498 498 498 498 498 498 498 498 498 498 498 498 498 498 498 498 498 498 498 498 498 499 660 0 0 0 0 0 
498 498 498 498 498 498 498 498 498 498 498 498 498 498 498 498 498 498 498 498 498 498 498 498 498 498 498 498 498 498 498 498 498 620 0 0 0 0 0 0 
498 498 498 498 498 498 498 498 498 498 498 498 498 498 498 498 498 498 498 498 498 498 498 498 498 498 498 498 498 498 498 498 498 620 0 0 0 0 0 0 
498 498 498 498 498 498 498 498 498 498 498 498 498 498 498 498 498 498 498 498 498 498 498 498 498 498 498 498 498 498 498 498 499 660 0 0 0 0 0 0 
498 498 498 498 498 498 498 498 498 498 498 498 498 498 498 498 498 498 498 498 498 498 498 498 498 498 498 498 498 498 498 498 620 0 0 0 0 0 0 0 
498 498 498 498 498 498 498 498 498 498 498 498 498 498 498 498 498 498 498 498 498 498 498 498 498 498 498 498 498 498 498 498 620 0 0 0 0 0 0 0 
498 498 498 498 498 498 498 498 498 498 498 498 498 498 498 498 498 498 498 498 498 498 498 498 498 498 498 498 498 498 498 498 620 0 0 0 0 0 0 0 
498 498 498 498 498 498 498 498 498 498 498 498 498 498 498 498 498 498 498 498 498 498 498 498 498 498 498 498 498 498 498 498 620 0 0 0 0 0 0 0 
498 498 498 498 498 498 498 498 498 498 498 498 498 498 498 498 498 498 498 498 498 498 498 498 498 498 498 498 498 498 498 498 620 0 0 0 0 0 0 0 
498 498 498 498 498 498 498 498 498 498 498 498 498 498 498 498 498 498 498 498 498 498 498 498 498 498 498 498 498 498 498 498 620 0 0 0 0 0 0 0 
498 498 498 498 498 498 498 498 498 498 498 498 498 498 498 498 498 498 498 498 498 498 498 498 498 498 498 498 498 498 498 499 660 0 0 0 0 0 0 0 
498 498 498 498 498 498 498 498 498 498 498 498 498 498 498 498 498 498 498 498 498 498 498 498 498 498 498 498 498 498 498 620 0 0 0 0 0 0 0 0 
498 498 498 498 498 498 498 498 498 498 498 498 498 498 498 498 498 498 498 498 498 498 498 498 498 498 498 498 498 498 499 660 0 0 0 0 0 0 0 0 
498 498 498 498 498 498 498 498 498 498 498 498 498 498 498 498 498 498 498 498 498 498 498 498 498 498 498 498 498 498 620 0 0 0 0 0 0 0 0 0 
498 498 498 498 498 498 498 498 498 498 498 498 498 498 498 498 498 498 498 498 498 498 498 498 498 498 498 498 498 499 660 0 0 0 0 0 0 0 0 0 
498 498 498 498 498 498 498 498 498 498 498 498 498 498 498 498 498 498 498 498 498 498 498 498 498 498 498 498 498 620 0 0 0 0 0 0 0 0 0 0 
498 498 498 498 498 498 498 498 498 498 498 498 498 498 498 498 498 498 498 498 498 498 498 498 499 659 659 659 659 660 0 0 0 0 0 0 0 0 0 0 
498 498 498 498 498 498 498 498 498 498 498 498 498 498 498 498 498 498 499 659 659 659 659 659 660 0 0 698 0 0 0 0 0 0 0 0 0 0 0 0 
498 498 498 498 498 498 498 498 498 498 498 498 498 498 498 499 659 659 660 0 0 0 0 0 0 0 0 698 0 0 0 0 0 0 0 0 0 0 0 0 
498 498 498 498 498 498 498 498 498 498 498 499 659 659 659 660 0 0 0 0 0 0 0 0 0 0 0 698 0 0 0 0 0 0 0 0 0 0 0 0 
498 498 498 498 498 498 498 498 498 499 659 660 0 0 698 0 0 0 0 0 0 0 0 0 0 0 0 698 0 0 0 0 0 0 0 0 0 0 0 0 
498 498 498 498 498 498 498 498 498 620 0 0 0 0 698 0 0 0 0 0 0 0 0 0 0 0 0 698 0 0 0 0 0 0 0 0 0 0 0 0 
498 498 498 498 498 498 498 498 499 660 0 0 0 0 698 0 0 0 0 0 0 0 0 0 0 0 0 698 0 0 0 0 0 0 0 0 0 0 0 0 
498 498 498 498 498 498 498 498 620 0 0 0 0 0 698 0 0 0 0 0 0 0 0 0 0 0 0 698 0 0 0 0 0 0 0 0 0 0 0 0 
498 498 498 498 498 498 498 498 620 699 699 699 699 699 700 699 699 699 699 699 699 699 699 699 699 699 699 700 699 699 699 699 699 699 699 699 699 699 699 699 
498 498 498 498 498 498 498 498 620 0 0 0 0 0 698 0 0 0 0 0 0 0 0 0 0 0 0 698 0 0 0 0 0 0 0 0 0 0 0 0 
498 498 498 498 498 498 498 498 620 0 0 0 0 0 698 0 0 0 0 0 0 0 0 0 0 0 0 698 0 0 0 0 0 0 0 0 0 0 0 0 
0
