480 480 480 480 480 480 480 480 602 0 0 0 0 0 680 0 0 0 0 0 0 0 0 0 0 0 0 680 0 0 0 0 0 0 0 0 0 0 0 0 
480 480 480 480 480 480 480 481 642 0 0 0 0 0 680 0 0 0 0 0 0 0 0 0 0 0 0 680 0 0 0 0 0 0 0 0 0 0 0 0 
480 480 480 480 480 480 480 602 0 0 0 0 0 0 680 0 0 0 0 0 0 0 0 0 0 0 0 680 0 0 0 0 0 0 0 0 0 0 0 0 
480 480 480 480 480 480 480 602 0 0 0 0 0 0 680 0 0 0 0 0 0 0 0 0 0 0 0 680 0 0 0 0 0 0 0 0 0 0 0 0 
480 480 480 480 480 480 481 642 0 0 0 0 0 0 680 0 0 0 0 0 0 0 0 0 0 0 0 680 0 0 0 0 0 0 0 0 0 0 0 0 
480 480 480 480 480 480 602 0 0 0 0 0 0 0 680 0 0 0 0 0 0 0 0 0 0 0 0 680 0 0 0 0 0 0 0 0 0 0 0 0 
480 480 480 480 480 480 602 0 0 0 0 0 0 0 680 0 0 0 0 0 0 0 0 0 0 0 0 680 0 0 0 0 0 0 0 0 0 0 0 0 
480 480 480 480 480 480 602 0 0 0 0 0 0 0 680 0 0 0 0 0 0 0 0 0 0 0 0 680 0 0 0 0 0 0 0 0 0 0 0 0 
480 480 480 480 480 480 602 0 0 0 0 0 0 0 680 0 0 0 0 0 0 0 0 0 0 0 0 680 0 0 0 0 0 0 0 0 0 0 0 0 
480 480 480 480 480 481 642 0 0 0 0 0 0 0 680 0 0 0 0 0 0 0 0 0 0 0 0 680 0 0 0 0 0 0 0 0 0 0 0 0 
480 480 480 480 480 602 0 0 0 0 0 0 0 0 680 0 0 0 0 0 0 0 0 0 0 0 0 680 0 0 0 0 0 0 0 0 0 0 0 0 
480 480 480 480 481 642 0 0 0 0 0 0 0 0 680 0 0 0 0 0 0 0 0 0 0 0 0 680 0 0 0 0 0 0 0 0 0 0 0 0 
480 480 480 480 602 0 0 0 0 0 0 0 0 0 680 0 0 0 0 0 0 0 0 0 0 0 0 680 0 0 0 0 0 0 0 0 0 0 0 0 
480 480 480 480 602 0 0 0 0 0 0 0 0 0 680 0 0 0 0 0 0 0 0 0 0 0 0 680 0 0 0 0 0 0 0 0 0 0 0 0 
480 480 480 480 602 0 0 0 0 0 0 0 0 0 680 0 0 0 0 0 0 0 0 0 0 0 0 680 0 0 0 0 0 0 0 0 0 0 0 0 
480 480 480 480 602 0 0 0 0 0 0 0 0 0 680 0 0 0 0 0 0 0 0 0 0 0 0 680 0 0 0 0 0 0 0 0 0 0 0 0 
480 480 480 480 602 0 0 0 0 0 0 0 0 0 680 0 0 0 0 0 0 0 0 0 0 0 0 680 0 0 0 0 0 0 0 560 561 561 561 561 
480 480 480 480 602 0 0 0 0 0 0 0 0 0 680 0 0 0 0 0 0 0 0 0 0 0 0 680 0 0 560 561 561 561 561 522 480 480 480 480 
480 480 480 480 602 0 0 0 0 0 0 0 560 561 561 561 561 561 561 561 561 561 561 561 561 561 561 561 561 561 522 480 480 480 480 480 480 480 480 480 
480 480 480 480 602 0 0 0 0 0 0 0 640 641 641 641 482 480 480 480 480 480 480 480 480 480 480 480 480 480 480 480 480 480 480 480 480 480 480 480 
480 480 480 480 602 0 0 0 0 0 0 0 0 0 0 0 640 641 641 482 480 480 480 480 480 480 480 480 480 480 480 480 480 480 480 480 480 480 480 480 
480 480 480 480 602 0 0 0 0 0 0 0 0 0 0 0 0 0 0 640 641 641 641 641 641 641 641 641 641 641 641 641 641 641 641 641 641 641 641 641 
480 480 480 480 602 0 0 0 0 0 0 0 0 0 0 0 0 0 0 0 0 0 0 680 0 0 0 680 0 0 0 680 0 0 0 680 0 0 0 680 
480 480 480 480 602 0 0 0 0 0 0 0 0 0 0 0 0 0 0 0 0 0 0 680 0 0 0 680 0 0 0 680 0 0 0 680 0 0 0 680 
480 480 480 480 521 562 0 0 0 0 0 0 0 0 0 0 0 0 0 0 0 0 0 680 0 0 0 680 0 0 0 680 0 0 0 680 0 0 0 680 
480 480 480 480 480 521 561 561 561 562 0 0 0 0 0 0 0 0 0 0 0 0 0 680 0 0 0 680 0 0 0 680 0 0 0 680 0 0 0 680 
480 480 480 480 480 480 480 480 480 521 561 561 561 561 562 0 0 0 0 0 0 0 0 680 0 0 0 680 0 0 0 680 0 0 0 680 0 0 0 680 
480 480 480 480 480 480 480 480 480 480 480 480 480 480 521 561 561 561 561 561 561 561 561 561 561 561 561 561 561 561 561 561 561 561 561 561 561 561 561 561 
480 480 480 480 480 480 480 480 480 480 480 480 480 480 480 480 480 480 480 480 480 480 480 480 480 480 480 480 480 480 480 480 480 480 480 480 480 480 480 480 
480 480 480 480 480 480 480 480 480 480 480 480 480 480 480 480 480 480 480 480 480 480 480 480 480 480 480 480 480 480 480 480 480 480 480 480 480 480 480 480 
1
15 5 8
