489 489 489 489 489 489 489 489 489 489 489 489 489 489 489 489 489 489 489 489 489 489 611 0 0 0 0 0 0 609 489 489 489 489 489 489 489 489 489 489 
489 489 489 489 489 489 489 489 489 489 489 489 489 489 489 489 489 489 489 489 489 490 651 0 0 0 0 0 0 609 489 489 489 489 489 489 489 489 489 489 
489 489 489 489 489 489 489 489 489 489 489 489 489 489 489 489 489 489 489 489 489 611 0 0 0 0 0 0 0 609 489 489 489 489 489 489 489 489 489 489 
489 489 489 489 489 489 489 489 489 489 489 489 489 489 489 489 489 489 489 489 490 651 0 0 0 0 0 0 0 609 489 489 489 489 489 489 489 489 489 489 
489 489 489 489 489 489 489 489 489 489 489 489 489 489 489 489 489 489 490 650 651 0 0 0 0 0 0 0 0 609 489 489 489 489 489 489 489 489 489 489 
489 489 489 489 489 489 489 489 489 489 489 489 489 489 489 489 490 650 651 0 0 0 0 0 0 0 0 0 0 609 489 489 489 489 489 489 489 489 489 489 
489 489 489 489 489 489 489 489 489 489 489 489 489 489 489 490 651 0 0 0 0 0 0 0 0 0 0 0 0 609 489 489 489 489 489 489 489 489 489 489 
489 489 489 489 489 489 489 489 489 489 489 489 489 490 650 651 0 0 0 0 0 0 0 0 0 0 0 0 0 609 489 489 489 489 489 489 489 489 489 489 
489 489 489 489 489 489 489 489 489 489 490 650 650 651 0 0 0 0 0 0 0 0 0 0 0 0 0 0 569 531 489 489 489 489 489 489 489 489 489 489 
489 489 489 489 489 489 489 489 490 650 651 0 0 0 0 0 0 0 0 0 0 0 0 0 0 0 0 0 609 489 489 489 489 489 489 489 489 489 489 489 
489 489 489 489 490 650 650 650 651 0 0 0 0 0 0 0 0 0 0 0 0 0 0 0 0 0 0 0 609 489 489 489 489 489 489 489 489 489 489 489 
650 650 650 650 651 0 0 0 0 0 0 0 0 0 0 0 0 0 0 0 0 0 0 0 0 0 0 0 609 489 489 489 489 489 489 489 489 489 489 489 
0 0 0 0 0 0 0 0 0 0 0 0 0 0 0 0 0 0 0 0 0 0 0 0 0 0 0 569 531 489 489 489 489 489 489 489 489 489 489 489 
0 0 0 0 0 0 0 0 0 0 0 0 0 0 0 0 0 0 0 0 0 0 0 0 0 0 0 609 489 489 489 489 489 489 489 489 489 489 489 489 
0 0 0 0 0 0 0 0 0 0 0 0 0 0 0 0 0 0 0 0 0 0 0 0 0 0 0 609 489 489 489 489 489 489 489 489 489 489 489 489 
0 0 0 0 0 0 0 0 0 0 0 0 0 0 0 0 0 0 0 0 0 0 0 0 0 0 569 531 489 489 489 489 489 489 489 489 489 489 489 489 
0 0 0 0 0 0 0 0 0 0 0 0 0 0 0 0 0 0 0 0 0 0 0 0 0 0 609 489 489 489 489 489 489 489 489 489 489 489 489 489 
0 0 0 0 0 0 0 0 0 0 0 0 0 0 0 0 0 0 0 0 0 0 0 0 0 0 609 489 489 489 489 489 489 489 489 489 489 489 489 489 
0 0 0 0 0 0 0 0 0 0 0 0 0 0 0 0 0 0 0 0 0 0 0 0 0 0 609 489 489 489 489 489 489 489 489 489 489 489 489 489 
0 0 0 0 0 0 0 0 0 0 0 0 0 0 0 0 0 0 0 0 0 0 0 0 0 569 531 489 489 489 489 489 489 489 489 489 489 489 489 489 
0 0 0 0 0 0 0 0 0 0 0 0 0 0 0 0 0 0 0 0 0 0 0 0 0 609 489 489 489 489 489 489 489 489 489 489 489 489 489 489 
0 0 0 0 0 0 0 0 0 0 0 0 0 0 0 0 0 0 0 0 0 0 0 0 0 609 489 489 489 489 489 489 489 489 489 489 489 489 489 489 
0 0 0 0 0 0 0 0 0 0 0 0 0 0 0 0 0 0 0 0 0 0 0 569 570 531 489 489 489 489 489 489 489 489 489 489 489 489 489 489 
0 0 0 0 0 0 0 0 0 0 0 0 0 0 0 0 0 0 0 0 569 570 570 531 489 489 489 489 489 489 489 489 489 489 489 489 489 489 489 489 
0 0 0 0 0 0 0 0 0 0 0 0 0 0 0 0 0 0 569 570 531 489 489 489 489 489 489 489 489 489 489 489 489 489 489 489 489 489 489 489 
0 0 0 0 0 0 0 0 0 0 0 0 0 0 0 0 569 570 531 489 489 489 489 489 489 489 489 489 489 489 489 489 489 489 489 489 489 489 489 489 
0 0 0 0 0 0 0 0 0 569 570 570 570 570 570 570 531 489 489 489 489 489 489 489 489 489 489 489 489 489 489 489 489 489 489 489 489 489 489 489 
0 0 0 0 0 0 569 570 570 531 489 489 489 489 489 489 489 489 489 489 489 489 489 489 489 489 489 489 489 489 489 489 489 489 489 489 489 489 489 489 
0 0 0 0 0 0 609 489 489 489 489 489 489 489 489 489 489 489 489 489 489 489 489 489 489 489 489 489 489 489 489 489 489 489 489 489 489 489 489 489 
0 0 0 0 0 0 609 489 489 489 489 489 489 489 489 489 489 489 489 489 489 489 489 489 489 489 489 489 489 489 489 489 489 489 489 489 489 489 489 489 
0
