0 0 0 0 0 0 0 0 0 695 0 0 0 0 0 0 0 0 0 0 0 0 0 0 0 0 615 495 495 495 495 495 495 495 495 495 495 495 495 495 
0 0 0 0 0 0 0 0 0 695 0 0 0 0 0 0 0 0 0 0 0 0 0 0 0 0 615 495 495 495 495 495 495 495 495 495 495 495 495 495 
0 0 0 0 0 0 0 0 0 695 0 0 0 0 0 0 0 0 0 0 0 0 0 0 0 0 615 495 495 495 495 495 495 495 495 495 495 495 495 495 
0 0 0 0 0 0 0 0 0 695 0 0 0 0 0 0 0 0 0 0 0 0 0 0 0 0 615 495 496 656 656 656 656 656 656 656 656 656 656 656 
0 0 0 0 0 0 0 0 0 695 0 0 0 0 0 0 0 0 0 0 0 0 0 0 0 0 615 495 617 375 376 376 376 376 376 376 376 376 376 376 
0 0 0 0 0 0 0 0 0 695 0 0 0 0 0 0 0 0 0 0 0 0 0 0 0 0 615 495 617 415 295 295 295 295 295 295 295 295 295 295 
0 0 0 0 0 0 0 0 0 695 0 0 0 0 0 0 0 0 0 0 0 0 0 575 576 576 537 495 617 415 295 295 295 295 295 295 295 295 295 295 
0 0 0 0 0 0 0 0 0 695 0 0 0 0 0 0 0 0 0 0 0 0 0 615 495 495 495 495 617 415 295 295 295 295 295 295 295 295 295 295 
0 0 0 0 0 0 0 0 0 695 0 0 0 0 0 0 0 0 0 0 0 0 0 615 495 495 495 495 617 415 295 295 295 295 295 295 295 295 295 295 
0 0 0 0 0 0 0 0 0 695 0 0 0 0 0 0 0 0 0 0 0 575 576 537 495 495 495 495 617 415 295 295 295 295 295 295 295 295 295 295 
0 0 0 0 0 0 0 0 0 695 0 0 0 0 0 0 0 0 0 0 0 615 495 495 495 495 495 495 617 455 456 456 456 456 456 456 456 456 456 456 
0 0 0 0 0 0 0 0 0 695 0 0 0 0 0 0 0 0 575 576 576 537 495 495 495 495 495 495 617 0 0 0 0 0 0 0 0 0 0 0 
0 0 0 0 0 0 0 0 0 695 0 0 0 0 0 0 0 0 615 495 495 495 495 495 495 495 495 495 617 0 0 0 0 0 0 0 0 0 0 0 
0 0 0 0 0 0 0 0 0 695 0 0 0 575 576 576 576 576 537 495 495 495 495 495 495 495 495 495 617 0 0 0 0 0 0 0 0 0 0 0 
0 0 0 0 0 0 0 575 576 576 576 576 576 537 495 495 495 495 495 495 495 495 495 495 495 495 495 495 617 0 0 0 0 0 0 0 0 0 0 0 
0 0 575 576 576 576 576 537 495 495 495 495 495 495 495 495 495 495 495 495 495 495 495 495 495 495 495 495 617 0 0 0 0 0 0 0 0 0 0 0 
576 576 537 495 495 495 495 495 495 495 495 495 495 495 495 495 495 495 495 495 495 495 495 495 495 495 495 495 617 0 0 0 0 0 0 0 0 0 0 0 
495 495 495 495 495 495 495 495 495 495 495 495 495 495 495 495 495 495 495 495 495 495 495 495 495 495 495 495 617 0 0 0 0 0 375 376 376 376 376 376 
495 495 495 495 495 495 495 495 495 495 495 495 495 495 495 495 495 495 495 495 495 495 495 495 495 495 495 495 617 0 0 0 0 0 415 295 295 295 295 295 
495 495 495 495 495 495 495 495 495 495 495 495 495 495 495 495 495 495 495 495 495 495 495 495 495 496 656 656 657 0 0 0 0 0 415 295 295 295 295 295 
495 495 495 495 495 495 495 495 495 495 495 495 495 495 495 495 495 495 495 495 496 656 656 656 656 657 0 695 0 0 0 0 0 0 415 295 295 295 295 295 
656 656 656 656 656 656 656 656 656 656 656 656 656 656 656 656 656 656 656 656 657 0 0 695 0 0 0 695 0 0 0 0 0 0 415 295 295 295 295 295 
0 0 0 695 0 0 0 695 0 0 0 695 0 0 0 695 0 0 0 695 0 0 0 695 0 0 0 695 0 0 0 0 0 0 415 295 295 295 295 295 
0 0 0 695 0 0 0 695 0 0 0 695 0 0 0 695 0 0 0 695 0 0 0 695 0 0 0 695 0 0 0 0 0 0 415 295 295 295 295 295 
0 0 0 695 0 0 0 695 0 0 0 695 0 0 0 695 0 0 0 695 0 0 0 695 0 0 0 695 0 0 0 0 0 0 415 295 295 295 295 295 
0 0 0 695 0 0 0 695 0 0 0 695 0 0 0 695 0 0 0 695 0 0 0 695 0 0 0 695 0 0 0 0 0 0 415 295 295 295 295 295 
0 0 0 695 0 0 0 695 0 0 0 695 0 0 0 695 0 0 0 695 0 0 0 695 0 0 0 695 0 0 0 0 0 0 415 295 295 295 295 295 
576 576 576 576 576 576 576 576 576 576 576 576 576 576 576 576 576 576 576 576 576 576 576 576 576 576 576 576 576 576 576 576 576 577 415 295 295 295 295 295 
495 495 495 495 495 495 495 495 495 495 495 495 495 495 495 495 495 495 495 495 495 495 495 495 495 495 495 495 495 495 495 495 495 617 415 295 295 295 295 295 
495 495 495 495 495 495 495 495 495 495 495 495 495 495 495 495 495 495 495 495 495 495 495 495 495 495 495 495 495 495 495 495 495 617 415 295 295 295 295 295 
1
35 15 10 1
