104 104 104 104 104 104 104 104 104 104 104 104 104 104 104 104 104 104 104 104 104 104 104 104 104 104 104 104 104 104 104 104 104 104 104 104 104 104 104 104 
265 265 265 265 106 105 265 265 265 265 265 265 265 106 104 105 265 265 265 265 265 265 265 106 105 265 265 265 265 265 265 265 106 104 105 265 265 265 265 265 
567 567 567 568 224 226 566 567 567 567 567 567 568 224 105 266 566 567 567 567 567 567 568 224 226 566 567 567 567 567 567 568 264 106 226 566 567 567 567 567 
486 486 608 184 146 266 606 486 486 486 487 647 648 224 226 566 528 486 486 486 487 647 648 224 226 606 486 486 486 486 486 527 568 224 226 606 486 486 486 486 
486 486 608 264 266 566 528 486 486 486 608 184 185 146 266 606 486 486 486 487 648 184 185 146 266 606 486 486 486 486 487 647 648 224 226 606 486 486 486 486 
486 486 527 567 567 528 486 486 486 486 608 264 265 266 566 528 486 486 486 608 184 146 105 266 566 528 486 486 486 486 608 184 185 146 266 606 486 486 486 486 
486 486 486 486 486 486 486 486 486 486 527 567 567 567 528 486 486 486 486 608 264 265 266 566 528 486 486 486 486 486 608 264 265 266 566 528 486 486 486 486 
486 486 486 486 486 486 486 486 486 486 486 486 486 486 486 486 486 486 486 527 567 567 567 528 486 486 486 486 486 486 527 567 567 567 528 486 486 486 486 486 
486 486 486 486 486 486 486 486 486 486 486 486 486 486 486 486 486 486 486 486 486 486 486 486 486 486 486 486 486 486 486 486 486 486 486 486 486 486 486 486 
486 486 486 486 486 486 486 486 486 486 486 486 486 486 486 486 486 486 486 486 486 486 486 486 486 486 486 486 486 486 486 486 486 486 486 486 486 486 486 486 
486 486 486 486 486 486 486 486 486 486 486 486 486 486 486 486 486 486 486 486 486 486 486 486 486 486 486 486 486 486 486 486 486 486 486 486 486 487 647 647 
486 486 486 486 486 486 486 486 486 486 486 486 486 486 486 486 486 486 486 486 486 486 486 486 486 486 486 486 486 486 486 486 486 487 647 647 647 648 0 0 
486 486 486 486 486 486 486 486 486 486 486 486 486 486 486 486 486 486 486 486 486 486 486 486 486 486 486 486 487 647 647 647 647 648 0 0 0 0 0 0 
486 486 486 486 486 486 486 486 486 486 486 486 487 647 647 647 647 647 647 647 647 647 647 647 647 647 647 647 648 0 0 0 0 0 0 0 0 0 0 0 
486 486 486 486 486 486 486 486 487 647 647 647 648 0 0 0 0 0 0 0 0 686 0 0 0 0 686 0 0 0 0 0 0 0 0 0 0 0 0 0 
486 487 647 647 647 647 647 647 648 0 0 0 0 0 0 0 0 0 0 0 0 686 0 0 0 0 686 0 0 0 0 0 0 0 0 0 0 0 0 0 
647 648 0 0 686 0 0 0 686 0 0 0 0 0 0 0 0 0 0 0 0 686 0 0 0 0 686 0 0 0 0 0 0 0 0 0 0 0 0 0 
0 0 0 0 686 0 0 0 686 0 0 0 0 0 0 0 0 0 0 0 0 686 0 0 0 0 686 0 0 0 0 0 0 0 0 0 0 0 0 0 
0 0 0 0 686 0 0 0 686 0 0 0 0 0 0 0 0 0 0 0 0 686 0 0 0 0 686 0 0 0 0 0 0 0 0 0 0 0 0 0 
0 0 0 0 686 0 0 0 686 0 0 0 0 0 0 0 0 0 0 0 0 686 0 0 0 0 686 0 0 0 0 0 0 0 0 0 0 0 0 0 
0 0 0 0 686 0 0 0 686 0 0 0 0 0 0 0 0 0 0 0 0 686 0 0 0 0 686 0 0 0 0 0 0 0 0 0 0 0 0 0 
0 0 0 0 686 0 0 0 686 0 0 0 0 0 0 0 0 0 0 0 0 686 0 0 0 0 686 0 0 0 0 0 0 0 0 0 0 0 0 0 
0 0 0 0 686 0 0 0 686 0 0 0 0 0 0 0 0 0 0 0 0 686 0 0 0 0 686 0 0 0 0 0 0 0 0 0 0 0 0 0 
0 0 0 0 686 0 0 0 686 0 0 0 0 0 0 0 0 0 0 0 566 567 567 567 567 567 567 568 0 0 0 0 0 0 0 0 0 0 0 0 
0 0 0 566 567 567 567 567 567 568 0 0 0 0 0 0 0 0 0 0 646 647 647 647 647 647 647 648 0 0 0 0 0 0 0 0 0 0 0 0 
0 0 0 646 647 647 647 647 647 648 0 0 0 0 0 0 0 0 0 0 0 0 0 0 0 0 0 0 0 0 0 0 0 0 0 0 0 0 0 0 
0 0 0 0 0 0 0 0 0 0 0 0 0 0 0 0 0 0 0 0 0 0 0 0 0 0 0 0 0 0 0 0 0 0 0 0 0 0 0 0 
0 0 0 0 0 0 0 0 0 0 0 0 0 0 0 0 0 0 0 0 0 0 0 0 0 0 0 0 0 0 0 0 0 0 0 0 0 0 0 0 
0 0 0 0 0 0 0 0 0 0 0 0 0 0 0 0 0 0 0 0 0 0 0 0 0 0 0 0 0 0 0 0 0 0 0 0 0 0 0 0 
0 0 0 0 0 0 0 0 0 0 0 0 0 0 0 0 0 0 0 0 0 0 0 0 0 0 0 0 0 0 0 0 0 0 0 0 0 0 0 0 
0
