107 107 107 107 107 107 107 107 107 107 107 107 107 107 107 107 229 744 745 905 905 746 744 227 107 107 107 107 107 107 107 107 107 107 107 107 107 107 107 107 
107 107 107 107 107 107 107 107 107 107 107 107 107 107 107 107 229 744 866 0 0 864 744 227 107 107 107 107 107 107 107 107 107 107 107 107 107 107 107 107 
107 107 107 107 107 107 107 107 107 107 107 107 107 107 107 107 229 744 866 0 0 864 744 227 107 107 107 107 107 107 107 107 107 107 107 107 107 107 107 107 
107 107 107 107 107 107 107 107 107 107 107 107 107 107 107 107 229 744 785 825 825 786 744 227 107 107 107 107 107 107 107 107 107 107 107 107 107 107 107 107 
107 107 107 107 107 107 107 107 107 107 107 107 107 107 107 107 229 744 744 744 744 744 744 227 107 107 107 107 107 107 107 107 107 107 107 107 107 107 107 107 
268 268 268 268 268 268 268 268 268 268 268 109 107 107 107 107 229 744 745 905 905 746 744 227 107 107 107 107 108 268 268 268 268 268 268 268 268 268 268 268 
744 744 744 744 744 744 744 744 744 744 744 227 107 107 107 107 229 744 866 0 0 864 744 227 107 107 107 107 229 744 744 744 744 744 744 744 744 744 744 744 
744 744 744 744 744 744 744 744 744 744 744 227 107 107 107 107 229 744 866 0 0 864 744 227 107 107 107 107 229 744 744 744 744 744 744 744 744 744 744 744 
744 744 744 744 744 744 744 744 744 744 744 227 107 107 107 107 229 744 785 825 825 786 744 227 107 107 107 107 229 744 744 744 744 744 744 744 744 744 744 744 
744 744 744 744 744 744 744 744 744 744 744 267 268 268 268 268 269 744 744 744 744 744 744 267 268 268 268 268 269 744 744 744 744 744 744 744 744 744 744 744 
744 744 744 744 744 744 744 744 744 744 744 744 744 744 744 744 744 744 745 905 905 746 744 744 744 744 744 744 744 744 744 744 744 744 744 744 744 744 744 744 
744 744 744 744 744 744 744 744 744 744 744 744 744 744 745 905 905 746 866 0 0 864 745 905 905 746 744 744 744 744 744 744 744 744 744 744 744 744 744 744 
744 744 744 744 744 744 744 744 744 744 745 905 905 746 866 0 0 864 866 0 0 864 866 0 0 864 745 905 905 746 744 744 744 744 744 744 744 744 744 744 
744 744 744 744 744 744 744 744 744 744 866 0 0 864 866 0 0 864 785 825 825 786 866 0 0 864 866 0 0 864 744 744 744 744 744 744 744 744 744 744 
744 744 744 744 744 744 744 744 744 744 866 0 0 864 785 825 825 786 744 744 744 744 785 825 825 786 866 0 0 864 744 744 744 744 744 744 744 744 744 744 
744 744 744 744 744 744 744 744 744 744 785 825 825 786 744 744 744 744 744 744 744 744 744 744 744 744 785 825 825 786 744 744 744 744 744 744 744 744 744 744 
744 744 744 744 744 744 187 188 188 188 188 188 188 188 188 188 188 188 188 188 188 188 188 188 188 188 188 188 188 188 188 188 188 189 744 744 744 744 744 744 
744 744 744 744 744 744 227 107 107 107 107 107 107 107 107 107 107 107 107 107 107 107 107 107 107 107 107 107 107 107 107 107 107 229 744 744 744 744 744 744 
744 744 744 744 744 744 267 268 268 268 268 268 268 268 268 268 268 268 268 268 268 268 268 268 268 268 268 268 268 268 268 268 268 269 744 744 744 744 744 744 
744 744 744 744 744 744 744 744 744 744 744 744 744 744 744 744 744 744 744 744 744 744 744 744 744 744 744 744 744 744 744 744 744 744 744 744 744 744 744 744 
744 744 744 744 744 744 744 744 744 744 745 905 905 905 905 905 905 905 905 905 905 905 905 905 905 905 905 905 905 746 744 744 744 744 744 744 744 744 744 744 
744 744 744 744 744 744 744 744 744 744 866 0 0 0 0 0 0 0 0 0 0 0 0 0 0 0 0 0 0 864 744 744 744 744 744 744 744 744 744 744 
744 744 744 744 744 744 744 744 744 744 866 0 0 0 0 0 0 0 0 0 0 0 0 0 0 0 0 0 0 864 744 744 744 744 744 744 744 744 744 744 
744 744 744 744 744 744 744 744 744 744 785 825 825 825 825 825 825 825 825 825 825 825 825 825 825 825 825 825 825 786 744 744 744 744 744 744 744 744 744 744 
744 744 744 744 744 744 744 744 744 744 744 744 744 744 744 744 744 744 744 744 744 744 744 744 744 744 744 744 744 744 744 744 744 744 744 744 744 744 744 744 
188 188 188 188 188 188 188 188 188 188 188 188 188 188 188 188 188 188 188 188 188 188 188 188 188 188 188 188 188 188 188 188 188 188 188 188 188 188 188 188 
107 107 107 107 107 107 107 107 107 107 107 107 107 107 107 107 107 107 107 107 107 107 107 107 107 107 107 107 107 107 107 107 107 107 107 107 107 107 107 107 
107 107 107 107 107 107 107 107 107 107 107 107 107 107 107 107 107 107 107 107 107 107 107 107 107 107 107 107 107 107 107 107 107 107 107 107 107 107 107 107 
107 107 107 107 107 107 107 107 107 107 107 107 107 107 107 107 107 107 107 107 107 107 107 107 107 107 107 107 107 107 107 107 107 107 107 107 107 107 107 107 
107 107 107 107 107 107 107 107 107 107 107 107 107 107 107 107 107 107 107 107 107 107 107 107 107 107 107 107 107 107 107 107 107 107 107 107 107 107 107 107 
0
