483 483 483 483 483 483 483 483 483 483 483 483 483 483 483 483 483 483 483 483 483 483 483 483 483 483 483 483 483 483 483 483 483 483 483 483 483 483 483 483 
483 483 483 483 483 483 483 483 483 483 483 483 483 483 483 483 483 483 483 483 483 483 483 483 483 483 483 483 483 483 483 483 483 483 483 483 483 483 483 483 
483 483 483 483 483 483 483 483 483 483 483 483 483 483 483 483 483 483 483 483 483 483 483 483 483 483 483 483 483 483 483 483 483 483 484 644 644 644 644 644 
483 483 483 483 483 483 483 483 483 483 483 483 483 483 483 483 483 483 483 483 483 483 483 483 483 483 483 483 483 483 483 484 644 644 645 0 0 0 0 0 
483 483 483 483 483 483 483 483 483 483 483 483 483 483 483 483 483 483 483 483 483 483 483 483 483 483 483 483 483 483 483 605 0 0 0 0 0 0 0 0 
483 483 483 483 483 483 483 483 483 483 483 483 483 483 483 483 483 483 483 483 483 483 483 483 483 483 483 483 483 484 644 645 0 0 0 0 0 0 0 0 
483 483 483 483 483 483 483 483 483 483 483 483 483 483 483 483 483 483 483 483 483 483 483 483 483 483 483 483 483 605 0 0 0 0 0 0 0 0 0 0 
483 483 483 483 483 483 483 483 483 483 483 483 483 483 483 483 483 483 483 483 483 483 483 483 483 483 483 483 484 645 0 0 0 0 0 0 0 0 563 564 
483 483 483 483 483 483 483 483 483 483 483 483 483 483 483 483 483 483 483 483 483 483 483 483 483 483 483 483 605 0 0 0 0 0 0 0 0 0 603 483 
483 483 483 483 483 483 483 483 483 483 483 483 483 483 483 483 483 483 483 483 483 483 483 483 483 483 483 483 605 0 0 0 0 0 0 0 563 564 525 483 
483 483 483 483 483 483 483 483 483 483 483 483 483 483 483 483 483 483 483 483 483 483 483 483 483 483 483 483 605 0 0 0 0 0 0 0 603 483 483 483 
644 644 644 644 644 644 644 644 644 644 644 644 644 644 644 644 485 483 483 483 483 483 483 483 483 483 483 484 645 0 0 0 0 0 0 563 525 483 483 483 
0 0 0 0 0 0 0 0 0 0 683 0 0 0 0 0 643 485 483 483 483 483 483 483 483 483 483 605 683 0 0 0 0 0 0 603 483 483 483 483 
0 0 0 0 0 0 0 0 0 0 683 0 0 0 0 0 0 643 644 485 483 483 483 483 483 483 483 605 683 0 0 0 0 0 0 603 483 483 483 483 
0 0 0 0 0 0 0 0 0 0 683 0 0 0 0 0 0 683 0 643 485 483 483 483 483 483 484 645 683 0 0 0 0 0 563 525 483 483 483 483 
0 0 0 0 0 0 0 0 0 0 683 0 0 0 0 0 0 683 0 0 603 483 483 483 483 483 605 0 683 0 0 0 0 0 603 483 483 483 483 483 
0 0 0 0 0 0 0 0 0 0 683 0 0 0 0 0 0 683 0 0 643 485 483 483 483 483 605 0 683 0 0 0 0 563 525 483 483 483 483 483 
6 6 6 6 6 6 6 6 6 563 564 564 565 0 0 0 0 683 0 0 0 643 644 644 644 644 645 0 683 0 0 0 0 603 483 483 483 483 483 483 
564 564 564 564 564 564 564 564 564 525 483 483 524 565 0 0 0 683 0 0 0 0 0 0 0 0 0 0 683 0 0 0 563 525 483 483 483 483 483 483 
483 483 483 483 483 483 483 483 483 483 483 483 483 524 565 0 0 683 0 0 0 0 0 0 0 0 0 0 683 0 0 0 603 483 483 483 483 483 483 483 
483 483 483 483 483 483 483 483 483 483 483 483 483 483 605 0 0 683 0 0 0 0 0 0 0 0 0 0 683 0 0 0 603 483 483 483 483 483 483 483 
483 483 483 483 483 483 483 483 483 483 483 483 483 483 524 565 0 683 0 0 0 0 0 0 0 0 0 0 683 0 0 0 603 483 483 483 483 483 483 483 
483 483 483 483 483 483 483 483 483 483 483 483 483 483 483 605 0 683 0 0 0 0 0 0 0 0 0 0 683 0 0 0 603 483 483 483 483 483 483 483 
483 483 483 483 483 483 483 483 483 483 483 483 483 483 483 524 564 565 0 0 0 0 0 0 0 0 0 0 683 0 0 0 603 483 483 483 483 483 483 483 
483 483 483 483 483 483 483 483 483 483 483 483 483 483 483 483 483 605 0 0 0 0 0 0 0 0 0 0 683 0 0 0 603 483 483 483 483 483 483 483 
483 483 483 483 483 483 483 483 483 483 483 483 483 483 483 483 483 524 564 565 0 0 0 0 0 0 0 0 563 564 564 564 525 483 483 483 483 483 483 483 
483 483 483 483 483 483 483 483 483 483 483 483 483 483 483 483 483 483 483 605 6 6 6 6 6 6 6 6 603 483 483 483 483 483 483 483 483 483 483 483 
483 483 483 483 483 483 483 483 483 483 483 483 483 483 483 483 483 483 483 524 564 564 564 564 564 564 564 564 525 483 483 483 483 483 483 483 483 483 483 483 
483 483 483 483 483 483 483 483 483 483 483 483 483 483 483 483 483 483 483 483 483 483 483 483 483 483 483 483 483 483 483 483 483 483 483 483 483 483 483 483 
483 483 483 483 483 483 483 483 483 483 483 483 483 483 483 483 483 483 483 483 483 483 483 483 483 483 483 483 483 483 483 483 483 483 483 483 483 483 483 483 
0
