0 0 0 0 0 0 0 0 0 0 0 0 0 0 0 0 0 618 498 498 498 498 498 498 498 498 498 498 498 498 498 498 498 498 498 498 498 498 498 498 
0 0 0 0 0 0 0 0 0 0 0 0 0 0 0 0 0 618 498 498 498 498 498 498 498 498 498 498 498 498 498 498 498 498 498 498 498 498 498 498 
0 0 0 0 0 0 0 0 0 0 0 0 0 0 0 0 0 618 498 498 498 498 498 498 498 498 498 498 498 498 498 498 498 498 498 498 498 498 498 498 
0 0 0 0 0 0 0 0 0 0 0 0 0 0 0 0 0 618 498 498 498 498 498 498 498 498 498 498 498 498 498 498 498 498 498 498 498 498 498 498 
0 0 0 0 0 0 0 0 0 0 0 0 0 0 0 0 0 618 498 498 498 498 498 498 498 498 498 498 498 498 498 498 498 498 498 498 498 498 498 498 
0 0 0 0 0 0 0 0 0 0 0 0 0 0 0 0 578 540 498 498 498 498 498 498 498 498 498 498 498 498 498 498 498 498 498 498 498 498 498 498 
0 0 0 0 0 0 0 0 0 0 0 0 0 0 0 0 618 498 498 498 498 498 498 498 498 498 498 498 498 498 498 498 498 498 498 498 498 498 498 498 
0 0 0 0 0 0 0 0 0 0 0 0 0 0 0 0 618 498 498 498 498 498 498 498 498 498 498 498 498 498 498 498 498 498 498 498 498 498 498 498 
0 0 0 0 0 0 0 0 0 0 0 0 0 0 0 578 540 498 498 498 498 498 498 498 498 498 498 498 498 498 498 498 498 498 498 498 498 498 498 498 
0 0 0 0 0 0 0 0 0 0 0 0 0 0 0 618 498 498 498 498 498 498 498 498 498 498 498 498 498 498 498 498 498 498 498 498 498 498 498 498 
0 0 0 0 0 0 0 0 0 0 0 0 0 0 0 618 498 498 498 498 498 498 498 498 498 498 498 498 498 498 498 498 498 498 498 498 498 498 498 498 
0 0 0 0 0 0 0 0 0 0 0 0 0 0 578 540 498 498 498 498 498 498 498 498 498 498 498 498 498 498 498 498 498 498 498 498 498 498 498 498 
0 0 0 0 0 0 0 0 0 0 0 0 0 0 618 498 498 498 498 498 498 498 498 498 498 498 498 498 498 498 498 498 498 498 498 498 498 498 498 498 
0 0 0 0 0 0 0 0 0 0 0 0 0 578 540 498 498 498 498 498 498 498 498 498 498 498 498 498 498 498 498 498 498 498 498 498 498 498 498 498 
0 0 0 0 0 0 0 0 0 0 0 0 0 618 498 498 498 498 498 498 498 498 498 498 498 498 498 498 498 498 498 498 498 498 498 498 498 498 498 498 
0 0 0 0 0 0 0 0 0 0 0 0 0 658 659 659 659 659 659 659 659 659 659 659 659 659 659 659 659 659 500 498 498 498 498 498 498 498 498 498 
0 0 0 0 0 0 0 0 0 0 0 0 0 0 0 0 0 0 0 0 0 0 0 0 0 0 0 0 0 0 618 498 498 498 498 498 498 498 498 498 
0 0 0 0 0 0 0 0 0 0 0 0 0 0 0 0 0 0 0 0 0 0 0 0 0 0 0 0 0 0 618 498 498 498 498 498 498 498 498 498 
0 0 0 0 0 0 0 0 0 0 0 0 0 0 0 0 0 0 0 0 0 0 0 0 0 0 0 0 0 0 618 498 498 498 498 498 498 498 498 498 
0 0 0 0 0 0 0 0 0 0 0 0 0 0 0 0 0 0 0 0 0 0 0 0 0 0 0 0 0 0 618 498 498 498 498 498 498 498 498 498 
0 0 0 0 0 0 0 0 0 0 0 0 0 0 0 0 0 0 0 0 0 0 0 0 0 0 0 0 0 0 618 498 498 498 498 498 498 498 498 498 
0 0 0 0 0 0 0 0 0 0 0 0 0 0 0 0 0 0 0 0 0 0 0 0 0 0 0 0 0 0 618 498 498 498 498 498 498 498 498 498 
0 0 0 0 0 0 0 0 0 0 0 0 0 0 0 0 0 0 0 0 0 0 0 0 0 0 0 0 0 0 618 498 498 498 498 498 498 498 498 498 
0 0 0 0 0 0 0 0 0 0 0 0 0 0 0 0 0 0 0 0 0 0 0 0 0 0 0 0 0 0 618 498 498 498 498 498 498 498 498 498 
0 0 0 0 0 0 0 0 0 0 0 0 0 0 0 0 0 0 0 0 0 0 0 0 0 0 0 0 0 0 618 498 498 498 498 498 498 498 498 498 
0 0 0 0 0 0 0 0 0 0 0 0 0 0 0 0 0 0 0 0 0 0 0 0 0 0 0 0 0 0 618 498 498 498 498 498 498 498 498 498 
0 0 0 0 0 0 0 0 0 0 0 0 0 0 0 0 0 0 0 0 0 0 0 0 0 0 0 0 0 0 618 498 498 498 498 498 498 498 498 498 
0 0 0 0 0 0 0 0 0 0 0 0 0 0 0 0 0 0 0 0 0 0 0 0 0 0 0 0 0 0 618 498 498 498 498 498 498 498 498 498 
0 0 0 0 0 0 0 0 0 0 0 0 0 0 0 0 0 0 0 0 0 0 0 0 0 0 0 0 0 0 618 498 498 498 498 498 498 498 498 498 
0 0 0 0 0 0 0 0 0 0 0 0 0 0 0 0 0 0 0 0 0 0 0 0 0 0 0 0 0 0 618 498 498 498 498 498 498 498 498 498 
1
19 16 10 0
