0 0 0 0 0 0 0 0 0 0 0 0 0 0 0 0 0 0 0 618 498 498 498 498 498 498 498 498 498 498 498 498 498 498 498 498 498 498 498 498 
0 0 0 0 0 0 0 0 0 0 0 0 0 0 0 0 0 0 0 618 498 498 498 498 498 498 498 498 498 498 498 498 498 498 498 498 498 498 498 498 
0 0 0 0 0 0 0 0 0 0 0 0 0 0 0 0 0 0 0 618 498 498 498 498 498 498 498 498 498 498 498 498 498 498 498 498 498 498 498 498 
0 0 0 0 0 0 0 0 0 0 0 0 0 0 0 0 0 0 0 618 498 498 498 498 498 498 498 498 498 498 498 498 498 498 498 498 498 498 498 498 
0 0 0 0 0 0 0 0 0 0 0 0 0 0 0 0 0 0 0 618 498 498 498 498 498 498 498 498 498 498 498 498 498 498 498 498 498 498 498 498 
0 0 0 0 0 0 0 0 0 0 0 0 0 0 0 0 0 0 0 658 500 498 498 498 498 498 498 498 498 498 498 498 498 498 498 498 498 498 498 498 
0 0 0 0 0 0 0 0 0 0 0 0 0 0 0 0 0 0 0 0 658 500 498 498 498 498 498 498 498 498 498 498 498 498 498 498 498 498 498 498 
0 0 0 0 0 0 0 0 0 0 0 0 0 0 0 0 0 0 0 0 0 618 498 498 498 498 498 498 498 498 498 498 498 498 498 498 498 498 498 498 
0 0 0 0 0 0 0 0 0 0 0 0 0 0 0 0 0 0 0 0 0 658 500 498 498 498 498 498 498 498 498 498 498 498 498 498 498 498 498 498 
0 0 0 0 0 0 0 0 0 0 0 0 0 0 0 0 0 0 0 0 0 0 618 498 498 498 498 498 498 498 498 498 498 498 498 498 498 498 498 498 
0 0 0 0 0 0 0 0 0 0 0 0 0 0 0 0 0 0 0 0 0 0 618 498 498 498 498 498 498 498 498 498 498 498 498 498 498 498 498 498 
0 0 0 0 0 0 0 0 0 0 0 0 0 0 0 0 0 0 0 0 0 0 658 500 498 498 498 498 498 498 498 498 498 498 498 498 498 498 498 498 
0 0 0 0 0 0 0 0 0 0 0 0 0 0 0 0 0 0 0 0 0 0 0 618 498 498 498 498 498 498 498 498 498 498 498 498 498 498 498 498 
0 0 0 0 0 0 0 0 0 0 0 0 0 0 0 0 0 0 0 0 0 0 0 618 498 498 498 498 498 498 498 498 498 498 498 498 498 498 498 498 
0 0 0 0 0 0 0 0 0 0 0 0 0 0 0 0 0 0 0 0 0 0 0 618 498 498 498 498 498 498 498 498 498 498 498 498 498 498 498 498 
0 0 0 0 0 0 0 0 0 0 0 0 0 0 0 0 0 0 0 0 0 0 0 618 498 498 498 498 498 498 498 498 498 498 498 498 498 498 498 498 
0 0 0 0 0 0 0 0 0 0 0 0 0 0 0 0 0 0 0 0 0 0 0 658 500 498 498 498 498 498 498 498 498 498 498 498 498 498 498 498 
0 0 0 0 0 0 0 0 0 0 0 0 0 0 0 0 0 0 0 0 0 0 0 0 618 498 498 498 498 498 498 498 498 498 498 498 498 498 498 498 
0 0 0 0 0 0 0 0 0 0 0 0 0 0 0 0 0 0 0 0 0 0 0 0 658 500 498 498 498 498 498 498 498 498 498 498 498 498 498 498 
0 0 0 0 0 0 0 0 0 0 0 0 0 0 0 0 0 0 0 0 0 0 0 0 0 618 498 498 498 498 498 498 498 498 498 498 498 498 498 498 
0 0 0 0 0 0 0 0 0 0 0 0 0 0 0 0 0 0 0 0 0 0 0 0 0 618 498 498 498 498 498 498 498 498 498 498 498 498 498 498 
0 0 0 0 0 0 0 0 0 0 0 0 0 0 0 0 0 0 0 0 0 0 0 0 0 618 498 498 498 498 498 498 498 498 498 498 498 498 498 498 
0 0 0 0 0 0 0 0 0 0 0 0 0 0 0 0 0 0 0 0 0 0 0 0 0 618 498 498 498 498 498 498 498 498 498 498 498 498 498 498 
0 0 0 0 0 0 0 0 0 0 0 0 0 0 0 0 0 0 0 0 0 0 0 0 0 658 500 498 498 498 498 498 498 498 498 498 498 498 498 498 
0 0 0 0 0 0 0 0 0 0 0 0 0 0 0 0 0 0 0 0 0 0 0 0 0 0 618 498 498 498 498 498 498 498 498 498 498 498 498 498 
0 0 0 0 0 0 0 0 0 0 0 0 0 0 0 0 0 0 0 0 0 0 0 0 0 0 618 498 498 498 498 498 498 498 498 498 498 498 498 498 
0 0 0 0 0 0 0 0 0 0 0 0 0 0 0 0 0 0 0 0 0 0 0 0 0 0 618 498 498 498 498 498 498 498 498 498 498 498 498 498 
0 0 0 0 0 0 0 0 0 0 0 0 0 0 0 0 0 0 0 0 0 0 0 0 0 0 618 498 498 498 498 498 498 498 498 498 498 498 498 498 
0 0 0 0 0 0 0 0 0 0 0 0 0 0 0 0 0 0 0 0 0 0 0 0 0 0 618 498 498 498 498 498 498 498 498 498 498 498 498 498 
0 0 0 0 0 0 0 0 0 0 0 0 0 0 0 0 0 0 0 0 0 0 0 0 0 0 618 498 498 498 498 498 498 498 498 498 498 498 498 498 
0
