0 0 212 92 214 0 0 0 0 0 0 0 0 0 0 0 0 0 0 0 0 0 0 0 0 0 0 0 0 0 0 0 0 0 0 212 92 214 0 0 
0 0 212 92 214 0 0 0 0 0 0 0 0 0 0 0 0 0 0 0 0 0 0 0 0 0 0 0 0 0 0 0 0 0 0 212 92 214 0 0 
0 0 252 253 254 0 0 0 0 0 0 0 0 0 0 0 0 0 0 0 0 0 0 0 0 0 0 0 0 0 0 0 0 0 0 252 253 254 0 0 
6 6 172 173 174 0 0 0 0 0 0 6 6 6 6 6 6 6 6 6 6 6 6 6 6 6 6 6 6 6 6 0 0 0 0 172 173 174 6 6 
173 174 212 92 214 0 0 0 0 0 0 172 173 173 173 173 173 173 173 173 173 173 173 173 173 173 173 173 173 173 174 0 0 0 0 212 92 214 172 173 
253 254 252 253 254 0 0 0 0 0 0 252 253 253 253 253 253 253 253 253 253 253 253 253 253 253 253 253 253 253 254 0 0 0 0 252 253 254 252 253 
0 0 0 0 0 0 0 0 0 0 0 7 7 7 7 7 7 7 0 0 0 0 0 0 0 0 0 0 0 0 0 0 0 0 0 0 0 0 0 0 
0 0 0 0 0 0 0 0 0 0 0 0 0 0 0 0 0 0 0 0 0 0 0 0 0 0 0 0 0 0 0 0 0 0 0 0 0 0 0 0 
0 0 0 0 0 0 0 0 0 0 0 0 0 0 0 0 0 0 0 0 0 0 0 0 0 0 0 0 0 0 0 0 0 0 0 0 0 0 0 0 
0 0 0 0 0 0 0 0 0 0 0 0 0 0 6 6 6 6 0 0 0 0 6 6 6 6 0 0 0 0 0 0 0 0 0 0 0 0 0 0 
0 0 0 0 0 0 0 0 0 0 0 0 0 0 172 173 173 174 0 0 0 0 172 173 173 174 0 0 0 0 0 0 0 0 0 0 0 0 0 0 
0 0 0 0 0 172 173 173 174 0 0 0 0 0 212 92 92 214 0 0 0 0 212 92 92 214 0 0 0 0 0 172 173 173 174 0 0 0 0 0 
6 6 6 6 6 252 253 253 254 6 6 6 6 6 252 253 253 254 0 0 0 0 252 253 253 254 6 6 6 6 6 252 253 253 254 6 6 6 6 6 
173 173 173 173 173 173 173 173 173 173 173 173 173 174 172 173 174 0 0 0 0 0 0 172 173 174 172 173 173 173 173 173 173 173 173 173 173 173 173 173 
92 92 92 92 92 92 92 92 92 92 92 92 92 214 212 92 214 0 0 0 0 0 0 212 92 214 212 92 92 92 92 92 92 92 92 92 92 92 92 92 
253 253 253 253 253 253 253 253 253 253 253 253 253 254 212 92 214 0 0 0 0 0 0 212 92 214 252 253 253 253 253 253 253 253 253 253 253 253 253 253 
7 7 172 173 174 7 7 7 7 7 7 7 7 7 212 92 214 0 0 0 0 0 0 212 92 214 7 7 7 7 7 7 7 7 7 172 173 174 7 7 
0 0 212 92 214 0 0 0 0 0 0 0 0 0 212 92 214 172 173 173 173 173 174 212 92 214 0 0 0 0 0 0 0 0 0 212 92 214 0 0 
0 0 252 253 254 0 0 0 0 0 0 0 0 0 252 253 254 252 253 253 253 253 254 252 253 254 0 0 0 0 0 0 0 0 0 252 253 254 0 0 
0 0 172 173 174 0 0 0 0 0 0 0 0 0 0 0 0 0 0 0 0 0 0 0 0 0 0 0 0 0 0 0 0 0 0 172 173 174 0 0 
0 0 212 92 214 0 0 0 0 0 0 0 0 0 0 0 0 0 0 0 0 0 0 0 0 0 0 0 0 0 0 0 0 0 0 212 92 214 0 0 
0 0 212 92 214 0 0 0 0 0 0 0 0 0 0 0 0 0 0 0 0 0 0 0 0 0 0 0 0 0 0 0 0 0 0 212 92 214 0 0 
0 0 212 92 214 0 0 0 0 0 0 0 0 0 0 0 0 0 0 0 0 0 0 0 0 0 0 0 0 0 0 0 0 0 0 212 92 214 0 0 
0 0 212 92 214 0 0 0 0 172 173 173 173 173 173 174 0 0 0 0 0 0 0 0 172 173 173 173 173 173 174 0 0 0 0 212 92 214 0 0 
0 0 212 92 214 0 0 0 0 252 253 253 253 253 253 254 0 0 0 0 0 0 0 0 252 253 253 253 253 253 254 0 0 0 0 212 92 214 0 0 
0 0 212 92 214 0 0 0 0 7 7 7 7 7 7 7 0 0 0 0 0 0 0 0 7 7 7 7 7 7 7 0 0 0 0 212 92 214 0 0 
0 0 212 92 214 0 0 0 0 0 0 0 0 0 0 0 0 0 0 0 0 0 0 0 0 0 0 0 0 0 0 0 0 0 0 212 92 214 0 0 
0 0 212 92 214 0 0 0 0 0 0 0 0 0 0 0 0 0 0 0 0 0 0 0 0 0 0 0 0 0 0 0 0 0 0 212 92 214 0 0 
0 0 212 92 214 0 0 0 0 0 0 0 0 0 0 0 0 0 0 0 0 0 0 0 0 0 0 0 0 0 0 0 0 0 0 212 92 214 0 0 
2
19 14 9
19 19 10 0
