95 95 95 95 95 217 0 0 0 0 215 95 95 95 95 95 95 95 95 95 95 95 95 95 95 95 95 95 95 95 95 95 95 95 95 95 95 95 95 95 
256 256 256 256 256 257 0 0 0 0 255 256 256 256 256 256 256 256 256 256 256 256 256 256 256 256 256 256 256 256 256 256 256 256 256 256 256 256 256 256 
0 0 0 0 0 0 0 0 0 0 0 0 0 0 0 0 0 0 0 0 0 0 0 0 0 0 0 0 0 0 0 0 0 0 0 0 0 0 0 0 
0 0 0 0 0 0 0 0 0 0 0 0 0 0 0 0 0 0 0 0 0 0 0 0 0 0 0 0 0 0 0 0 0 0 0 0 0 0 0 0 
0 0 0 0 0 0 0 0 0 0 0 0 0 0 0 0 0 0 0 0 0 0 0 0 0 0 0 0 0 0 0 0 0 0 0 0 0 0 0 0 
0 0 0 0 0 0 0 0 0 0 0 0 0 0 0 0 0 0 0 0 0 0 0 0 0 0 0 0 0 0 0 0 0 0 0 0 0 0 0 0 
176 176 176 176 176 176 176 176 176 177 175 176 177 0 0 0 0 175 176 177 175 176 176 176 176 176 176 176 176 176 176 176 176 176 176 176 176 176 176 176 
256 256 256 256 256 256 256 256 256 257 215 95 217 0 0 0 0 215 95 217 255 256 256 256 256 256 256 256 256 256 256 256 256 256 256 256 256 256 256 256 
0 0 0 0 0 0 0 0 0 0 215 95 217 0 0 0 0 255 256 257 0 0 0 0 0 0 0 0 0 0 0 0 0 0 0 0 0 0 0 0 
0 0 0 0 0 0 0 0 0 0 215 95 217 0 0 0 0 175 176 177 0 0 0 0 0 0 0 0 0 0 0 0 0 0 0 0 0 0 0 0 
0 0 0 0 0 0 0 0 0 0 215 95 217 0 0 0 0 215 95 217 0 0 0 0 0 0 0 0 0 0 0 0 0 0 0 0 0 0 0 0 
0 0 0 0 0 0 0 0 0 0 215 95 217 0 0 0 0 215 95 217 0 0 0 0 0 0 0 0 0 0 0 0 0 0 0 0 0 0 0 0 
176 176 176 176 176 177 0 0 0 0 215 95 217 0 0 0 0 215 95 217 0 0 0 0 175 176 176 177 175 176 176 176 177 175 176 176 176 176 176 176 
95 95 95 95 95 217 0 0 0 0 215 95 217 0 0 0 0 215 95 217 0 0 0 0 215 95 95 217 215 95 95 95 217 215 95 95 95 95 95 95 
95 95 95 95 95 217 0 0 0 0 215 95 217 0 0 0 0 215 95 217 0 0 0 0 215 95 95 217 215 95 95 95 217 215 95 95 95 95 95 95 
95 95 95 95 95 217 0 0 0 0 215 95 217 0 0 0 0 215 95 217 0 0 0 0 215 95 95 217 215 95 95 95 217 215 95 95 95 95 95 95 
256 256 256 256 256 257 0 0 0 0 215 95 217 0 0 0 0 215 95 217 0 0 0 0 215 95 95 217 255 256 256 256 257 255 256 256 256 256 256 256 
0 0 0 0 0 0 0 0 0 0 215 95 217 0 0 0 0 215 95 217 0 0 0 0 215 95 95 217 0 0 0 0 0 0 0 0 0 0 0 0 
0 0 0 0 0 0 0 0 0 0 215 95 217 0 0 0 0 215 95 217 0 0 0 0 215 95 95 217 0 0 0 0 0 0 0 0 0 0 0 0 
0 0 0 0 0 0 0 0 0 0 215 95 217 0 0 0 0 215 95 217 0 0 0 0 215 95 95 217 0 0 0 0 0 0 0 0 0 0 0 0 
0 0 0 0 0 0 0 0 0 0 255 256 257 0 0 0 0 215 95 217 0 0 0 0 255 256 256 257 0 0 0 0 0 0 0 0 0 0 0 0 
176 176 176 176 176 176 176 176 176 176 176 176 177 0 0 0 0 255 256 257 0 0 0 0 175 176 176 176 176 176 176 176 176 176 176 176 176 176 176 176 
95 95 95 95 95 95 95 95 95 95 95 95 217 0 0 0 0 0 0 0 0 0 0 0 215 95 95 95 95 95 95 95 95 95 95 95 95 95 95 95 
256 256 256 256 256 256 256 256 256 256 97 95 217 0 0 0 0 0 0 0 0 0 0 0 215 95 96 256 256 256 256 256 256 256 256 256 256 256 256 256 
135 135 135 135 135 135 135 135 135 135 215 95 217 0 0 0 0 0 0 0 0 0 0 0 215 95 217 135 135 135 135 135 135 135 135 135 135 135 135 135 
135 135 135 135 135 135 135 135 135 135 215 95 217 0 0 0 0 0 0 0 0 0 0 0 215 95 217 135 135 135 135 135 135 135 135 135 135 135 135 135 
135 135 135 135 135 135 135 135 135 135 215 95 217 175 176 176 176 176 176 176 176 176 176 177 215 95 217 135 135 135 135 135 135 135 135 135 135 135 135 135 
135 135 135 135 135 135 135 135 135 135 215 95 217 215 95 95 95 95 95 95 95 95 95 217 215 95 217 135 135 135 135 135 135 135 135 135 135 135 135 135 
135 135 135 135 135 135 135 135 135 135 215 95 217 215 95 95 95 95 95 95 95 95 95 217 215 95 217 135 135 135 135 135 135 135 135 135 135 135 135 135 
5
4 3 1 3 4 -56 -40 384 312
12 3 1 3 4 -56 -40 384 312
20 3 1 3 4 -56 -40 384 312
28 3 1 3 4 -56 -40 384 312
29 19 10 1
