89 89 89 89 89 89 89 89 89 89 89 89 89 89 89 89 89 211 209 89 89 211 209 89 89 89 89 89 89 89 89 89 89 89 89 89 89 89 89 89 
250 250 250 250 250 250 250 250 250 250 250 250 250 250 250 250 250 251 249 250 250 251 249 250 250 250 250 250 250 250 250 250 250 250 250 250 250 250 250 250 
0 0 0 0 0 0 0 0 0 0 0 0 0 0 0 0 0 0 0 0 0 0 0 0 0 0 0 0 0 0 0 0 0 0 0 0 0 0 0 0 
0 0 0 0 0 0 0 0 0 0 0 0 0 0 0 0 0 0 0 0 0 0 0 0 0 0 0 0 0 0 0 0 0 0 0 0 0 0 0 0 
0 0 0 0 0 0 0 0 0 0 0 0 0 0 0 0 0 0 0 0 0 0 0 0 0 0 0 0 0 0 0 0 0 0 0 0 0 0 0 0 
0 0 0 0 0 0 0 0 0 0 0 0 0 0 0 0 0 0 0 0 0 0 0 0 0 0 0 0 0 0 0 0 0 0 0 0 0 0 0 0 
170 170 170 170 170 170 170 170 170 170 170 170 170 170 170 170 170 171 169 170 170 171 0 0 0 169 170 170 170 170 170 170 170 170 170 170 170 170 170 170 
89 89 89 89 89 89 89 89 89 89 89 89 89 89 89 89 89 211 209 89 89 211 0 0 0 209 89 89 89 89 89 89 89 89 89 89 89 89 89 89 
250 250 250 250 250 250 250 250 250 250 250 250 250 250 250 250 250 251 209 89 89 211 0 0 0 249 250 250 250 250 250 250 250 250 250 250 250 250 250 250 
0 0 0 0 0 0 0 0 0 0 0 0 0 0 0 0 0 0 249 250 250 251 0 0 0 0 0 0 0 0 0 0 0 0 0 0 0 0 0 0 
0 0 0 0 0 0 0 0 0 0 0 0 0 0 0 0 0 0 7 7 7 7 0 0 0 0 0 0 0 0 0 0 0 0 0 0 0 0 0 0 
0 0 0 0 0 0 0 0 0 0 0 0 0 0 0 0 0 0 6 6 6 6 0 0 0 0 0 0 0 0 0 0 0 0 0 0 0 0 0 0 
0 0 0 0 0 0 0 0 0 0 0 0 0 0 0 0 0 0 169 170 170 171 0 0 0 0 0 0 0 0 0 0 0 0 0 0 0 0 0 0 
170 170 170 170 170 170 170 170 170 170 170 170 170 170 171 0 0 0 209 89 89 211 169 170 170 170 170 170 170 170 170 170 170 170 170 170 170 170 170 170 
89 89 89 89 89 89 89 89 89 89 89 89 89 89 211 0 0 0 209 89 89 211 209 89 89 89 89 89 89 89 89 89 89 89 89 89 89 89 89 89 
250 250 250 250 250 250 250 250 250 250 250 250 250 250 251 0 0 0 209 89 89 211 249 250 250 250 250 250 250 250 250 250 250 250 250 250 250 250 250 250 
0 0 0 0 0 0 0 0 0 0 0 0 0 0 0 0 0 0 249 250 250 251 0 0 0 0 0 0 0 0 0 0 0 0 0 0 0 0 0 0 
0 0 0 0 0 0 0 0 0 0 0 0 0 0 0 0 0 0 7 7 7 7 0 0 0 0 0 0 0 0 0 0 0 0 0 0 0 0 0 0 
0 0 0 0 0 0 0 0 0 0 0 0 0 0 0 0 0 0 6 6 6 6 0 0 0 0 0 0 0 0 0 0 0 0 0 0 0 0 0 0 
0 0 0 0 0 0 0 0 0 0 0 0 0 0 0 0 0 0 169 170 170 171 0 0 0 0 0 0 0 0 0 0 0 0 0 0 0 0 0 0 
170 170 170 170 170 170 170 170 170 170 170 170 170 170 170 170 170 171 209 89 89 211 0 0 0 169 170 170 170 170 170 170 170 170 170 170 170 170 170 170 
89 89 89 89 89 89 89 89 89 89 89 89 89 89 89 89 89 211 209 89 89 211 0 0 0 209 89 89 89 89 89 89 89 89 89 89 89 89 89 89 
250 250 250 250 250 250 250 250 250 250 250 250 250 250 250 250 250 251 249 250 250 251 0 0 0 249 250 250 250 250 250 250 250 250 250 250 250 250 250 250 
0 0 0 0 0 0 0 0 0 0 0 0 0 0 0 0 0 0 0 0 0 0 0 0 0 0 0 0 0 0 0 0 0 0 0 0 0 0 0 0 
0 0 0 0 0 0 0 0 0 0 0 0 0 0 0 0 0 0 0 0 0 0 0 0 0 0 0 0 0 0 0 0 0 0 0 0 0 0 0 0 
0 0 0 0 0 0 0 0 0 0 0 0 0 0 0 0 0 0 0 0 0 0 0 0 0 0 0 0 0 0 0 0 0 0 0 0 0 0 0 0 
0 0 0 0 0 0 0 0 0 0 0 0 0 0 0 0 0 0 0 0 0 0 0 0 0 0 0 0 0 0 0 0 0 0 0 0 0 0 0 0 
170 170 170 170 170 170 170 170 170 170 170 170 170 170 170 170 170 171 169 170 170 171 169 170 170 170 170 170 170 170 170 171 0 0 0 0 169 170 170 170 
89 89 89 89 89 89 89 89 89 89 89 89 89 89 89 89 89 211 209 89 89 211 209 89 89 89 89 89 89 89 89 211 0 0 0 0 209 89 89 89 
4
37 4 10 1
23 24 1 3 8 -24 -24 344 264
11 17 1 2 8 -40 -32 352 272
23 10 1 3 8 -40 -32 360 272
