83 83 205 0 0 0 0 0 203 83 83 83 83 83 83 83 83 205 203 83 83 83 205 0 0 0 0 0 203 83 83 83 205 0 0 0 0 0 203 83 
83 83 205 0 0 0 0 0 243 244 244 244 244 244 244 244 244 245 203 83 83 83 205 0 0 0 0 0 243 244 244 244 245 0 0 0 0 0 203 83 
83 83 205 0 0 0 0 0 0 0 0 0 0 0 0 0 0 0 203 83 83 83 205 0 0 0 0 0 0 0 0 0 0 0 0 0 0 0 203 83 
83 83 205 0 0 0 0 0 0 0 0 0 0 0 0 0 0 0 203 83 83 83 205 0 0 0 0 0 0 0 0 0 0 0 0 0 0 0 203 83 
83 83 205 0 0 0 0 0 0 0 0 0 0 0 0 0 0 0 203 83 83 83 205 0 0 0 0 0 0 0 0 0 0 0 0 0 0 0 203 83 
83 83 205 0 0 0 0 0 0 0 0 0 0 0 0 0 0 0 203 83 83 83 205 0 0 0 0 0 0 0 0 0 0 0 0 0 0 0 203 83 
83 83 205 0 0 0 0 0 0 0 0 0 0 0 0 0 0 0 203 83 83 83 205 0 0 0 0 0 0 0 0 0 0 0 0 0 0 0 203 83 
83 83 205 0 0 0 0 0 0 0 0 0 0 0 0 0 0 0 243 244 244 244 245 0 0 0 0 0 0 0 0 0 0 0 0 0 0 0 203 83 
83 83 205 0 0 0 0 0 163 164 164 164 165 0 0 0 0 0 163 164 164 164 164 164 164 164 164 164 164 164 164 164 165 0 0 0 0 0 203 83 
83 83 205 0 0 0 0 0 203 83 83 83 205 0 0 0 0 0 203 83 83 83 83 83 83 83 83 83 83 83 83 83 205 0 0 0 0 0 203 83 
244 244 245 0 0 0 0 0 203 83 83 83 205 0 0 0 0 0 203 83 84 244 244 244 244 244 244 244 244 244 85 83 205 0 0 0 0 0 243 244 
0 0 0 0 0 0 0 0 203 83 83 83 205 0 0 0 0 0 203 83 205 123 123 123 123 123 123 123 123 123 203 83 205 0 0 0 0 0 0 0 
0 0 0 0 0 0 0 0 203 83 83 83 205 0 0 0 0 0 203 83 205 123 123 123 123 123 123 123 123 123 203 83 205 0 0 0 0 0 0 0 
0 0 0 0 0 0 0 0 203 83 83 83 205 0 0 0 0 0 203 83 205 123 123 123 123 123 123 123 123 123 203 83 205 0 0 0 0 0 0 0 
0 0 0 0 0 0 0 0 203 83 83 83 205 0 0 0 0 0 203 83 205 123 123 123 123 123 123 123 123 123 203 83 205 0 0 0 0 0 0 0 
0 0 0 0 0 0 0 0 203 83 83 83 205 0 0 0 0 0 203 83 205 123 123 123 123 123 123 123 123 123 203 83 205 0 0 0 0 0 0 0 
0 0 0 0 0 0 0 0 203 83 83 83 205 0 0 0 0 0 203 83 205 123 123 123 123 123 123 123 123 123 203 83 205 0 0 0 0 0 0 0 
0 0 0 0 0 0 0 0 203 83 83 83 205 0 0 0 0 0 203 83 205 123 123 123 123 123 123 123 123 123 203 83 205 0 0 0 0 0 0 0 
164 164 165 0 0 0 0 0 203 83 83 83 205 0 0 0 0 0 203 83 124 164 164 164 164 164 164 164 164 164 125 83 205 0 0 0 0 0 163 164 
83 83 205 0 0 0 0 0 203 83 83 83 205 0 0 0 0 0 203 83 83 83 83 83 83 83 83 83 83 83 83 83 205 0 0 0 0 0 203 83 
83 83 205 0 0 0 0 0 203 83 83 83 205 0 0 0 0 0 243 244 244 244 244 244 244 244 244 244 244 244 244 244 245 0 0 0 0 0 203 83 
83 83 205 0 0 0 0 0 203 83 83 83 205 0 0 0 0 0 0 0 0 0 0 0 0 0 0 0 163 164 164 164 165 0 0 0 0 0 203 83 
83 83 205 0 0 0 0 0 203 83 83 83 205 0 0 0 0 0 0 0 0 0 0 0 0 0 0 0 203 83 83 83 205 0 0 0 0 0 203 83 
83 83 205 0 0 0 0 0 203 83 83 83 205 0 0 0 0 0 0 0 0 0 0 0 0 0 0 0 203 83 83 83 205 0 0 0 0 0 203 83 
83 83 205 0 0 0 0 0 203 83 83 83 205 0 0 0 0 0 0 0 0 0 0 0 0 0 0 0 203 83 83 83 205 0 0 0 0 0 203 83 
83 83 205 0 0 0 0 0 203 83 83 83 205 0 0 0 0 0 0 0 0 0 0 0 0 0 0 0 203 83 83 83 205 0 0 0 0 0 203 83 
83 83 205 0 0 0 0 0 203 83 83 83 205 0 0 0 0 0 0 0 0 0 0 0 0 0 0 0 203 83 83 83 205 0 0 0 0 0 203 83 
83 83 205 0 0 0 0 0 203 83 83 83 205 163 164 164 164 164 164 164 164 164 165 0 0 0 0 0 203 83 83 83 205 0 0 0 0 0 203 83 
83 83 205 0 0 0 0 0 203 83 83 83 205 203 83 83 83 83 83 83 83 83 205 0 0 0 0 0 203 83 83 83 205 0 0 0 0 0 203 83 
0
