83 83 83 83 83 205 0 0 0 0 203 83 83 83 83 83 83 205 0 0 0 0 203 83 83 83 83 83 83 205 0 0 0 0 203 83 83 83 83 83 
83 83 83 83 83 205 0 0 0 0 203 83 83 83 83 83 83 205 0 0 0 0 203 83 83 83 83 83 83 205 0 0 0 0 203 83 83 83 83 83 
244 244 244 244 244 245 0 0 0 0 243 244 244 244 244 244 244 245 0 0 0 0 243 244 244 244 244 244 244 245 0 0 0 0 243 244 244 244 244 244 
164 164 164 165 0 0 0 0 0 0 0 0 163 164 164 165 0 0 0 0 0 0 0 0 163 164 164 165 0 0 0 0 0 0 0 0 163 164 164 164 
83 83 83 205 0 0 0 0 0 0 0 0 203 83 83 205 0 0 0 0 0 0 0 0 203 83 83 205 0 0 0 0 0 0 0 0 203 83 83 83 
83 83 83 205 0 0 0 0 0 0 0 0 203 83 83 205 0 0 0 0 0 0 0 0 203 83 83 205 0 0 0 0 0 0 0 0 203 83 83 83 
83 83 83 205 0 0 0 0 0 0 0 0 203 83 83 205 0 0 0 0 0 0 0 0 203 83 83 205 0 0 0 0 0 0 0 0 203 83 83 83 
83 83 83 205 0 0 0 0 0 0 0 0 203 83 83 205 0 0 0 0 0 0 0 0 203 83 83 205 0 0 0 0 0 0 0 0 243 244 244 244 
83 83 83 205 0 0 0 0 0 0 0 0 203 83 83 205 0 0 0 0 0 0 0 0 203 83 83 205 0 0 0 0 0 0 0 0 0 0 0 0 
83 83 83 205 0 0 0 0 0 0 0 0 203 83 83 205 0 0 0 0 0 0 0 0 203 83 83 205 0 0 0 0 0 0 0 0 0 0 0 0 
83 83 83 205 0 0 0 0 0 0 0 0 203 83 83 205 0 0 0 0 0 0 0 0 203 83 83 205 0 0 0 0 0 0 0 0 0 0 0 0 
83 83 83 205 0 0 0 0 0 0 0 0 203 83 83 205 0 0 0 0 0 0 0 0 203 83 83 205 0 0 0 0 0 0 0 0 0 0 0 0 
83 83 83 205 0 0 0 0 0 0 0 0 203 83 83 205 0 0 0 0 0 0 0 0 203 83 83 205 163 164 164 164 164 164 164 164 164 164 164 165 
83 83 83 205 0 0 0 0 0 0 0 0 203 83 83 205 0 0 0 0 0 0 0 0 203 83 83 205 203 83 83 83 83 83 83 83 83 83 83 205 
83 83 83 205 0 0 0 0 0 0 0 0 203 83 83 205 0 0 0 0 0 0 0 0 243 244 244 245 243 244 244 244 244 244 244 244 244 244 244 245 
83 83 83 205 0 0 0 0 0 0 0 0 203 83 83 205 0 0 0 0 0 0 0 0 0 0 0 0 0 0 0 0 0 0 0 0 163 164 164 164 
83 83 83 205 0 0 0 0 0 0 0 0 203 83 83 205 0 0 0 0 0 0 0 0 0 0 0 0 0 0 0 0 0 0 0 0 203 83 83 83 
83 83 83 205 0 0 0 0 0 0 0 0 203 83 83 205 0 0 0 0 0 0 0 0 0 0 0 0 0 0 0 0 0 0 0 0 203 83 83 83 
83 83 83 205 0 0 0 0 0 0 0 0 203 83 83 205 0 0 0 0 0 0 0 0 0 0 0 0 0 0 0 0 0 0 0 0 203 83 83 83 
83 83 83 205 0 0 0 0 0 0 0 0 203 83 83 205 163 164 164 164 164 164 164 164 164 164 164 165 0 0 0 0 0 0 0 0 203 83 83 83 
83 83 83 205 0 0 0 0 0 0 0 0 203 83 83 205 203 83 83 83 83 83 83 83 83 83 83 205 0 0 0 0 0 0 0 0 203 83 83 83 
83 83 83 205 0 0 0 0 0 0 0 0 243 244 244 245 243 244 244 244 244 244 244 244 244 244 244 245 0 0 0 0 0 0 0 0 203 83 83 83 
83 83 83 205 0 0 0 0 0 0 0 0 0 0 0 0 0 0 0 0 0 0 163 164 164 164 164 165 0 0 0 0 0 0 0 0 203 83 83 83 
83 83 83 205 0 0 0 0 0 0 0 0 0 0 0 0 0 0 0 0 0 0 203 83 83 83 83 205 0 0 0 0 0 0 0 0 203 83 83 83 
83 83 83 205 0 0 0 0 0 0 0 0 0 0 0 0 0 0 0 0 0 0 203 83 83 83 83 205 0 0 0 0 0 0 0 0 203 83 83 83 
244 244 244 245 0 0 0 0 0 0 0 0 0 0 0 0 0 0 0 0 0 0 243 244 244 244 244 245 0 0 0 0 0 0 0 0 243 244 244 244 
164 164 164 164 164 165 0 0 0 0 163 164 164 164 164 164 164 165 0 0 0 0 163 164 164 164 164 164 164 165 0 0 0 0 163 164 164 164 164 164 
83 83 83 83 83 205 0 0 0 0 203 83 83 83 83 83 83 205 0 0 0 0 203 83 83 83 83 83 83 205 0 0 0 0 203 83 83 83 83 83 
83 83 83 83 83 205 0 0 0 0 203 83 83 83 83 83 83 205 0 0 0 0 203 83 83 83 83 83 83 205 0 0 0 0 203 83 83 83 83 83 
3
31 10 10 1
17 16 1 3 3 128 120 288 152
13 24 10 1
