213 212 92 214 172 174 0 0 0 0 0 0 212 214 0 0 0 0 0 0 212 214 0 0 0 0 0 0 212 214 0 0 0 0 0 0 212 92 92 92 
213 212 92 214 252 254 0 0 0 0 0 0 212 214 0 0 0 0 0 0 212 214 0 0 0 0 0 0 212 214 0 0 0 0 0 0 212 92 92 92 
213 212 92 214 0 0 0 0 0 0 0 0 212 214 0 0 0 0 0 0 212 214 0 0 0 0 0 0 212 214 0 0 0 0 0 0 212 92 92 92 
213 212 92 214 0 0 0 0 0 0 0 0 212 214 0 0 0 0 0 0 212 214 0 0 0 0 0 0 212 214 0 0 0 0 0 0 212 92 92 92 
213 212 92 214 0 0 0 0 0 0 0 0 212 214 0 0 0 0 0 0 212 214 0 0 0 0 0 0 212 214 0 0 0 0 0 0 212 92 92 92 
213 212 92 214 0 0 0 0 0 0 0 0 252 254 0 0 0 0 0 0 212 214 0 0 0 0 0 0 212 214 0 0 0 0 0 0 212 92 92 92 
213 212 92 214 0 0 0 0 0 0 0 0 7 7 0 0 0 0 0 0 212 214 0 0 0 0 0 0 212 214 0 0 0 0 0 0 212 92 92 92 
213 212 92 214 0 0 0 0 0 0 0 0 0 0 0 0 0 0 0 0 212 214 0 0 0 0 0 0 252 254 0 0 0 0 0 0 212 92 92 92 
213 212 92 214 0 0 0 0 0 0 0 0 0 0 0 0 0 0 0 0 212 214 0 0 0 0 0 0 7 7 0 0 0 0 0 0 212 92 92 92 
213 212 92 214 0 0 0 0 0 0 0 0 0 0 0 0 0 0 0 0 212 214 0 0 0 0 0 0 0 0 0 0 0 0 0 0 212 92 92 92 
213 212 92 214 0 0 0 0 0 0 0 0 0 0 0 0 0 0 0 0 212 214 0 0 0 0 0 0 0 0 0 0 0 0 0 0 212 92 92 92 
213 212 92 214 0 0 0 0 0 0 0 0 0 0 0 0 0 0 0 0 212 214 0 0 0 0 0 0 0 0 0 0 0 0 0 0 252 253 253 253 
213 212 92 214 0 0 0 0 0 0 0 0 0 0 0 0 0 0 0 0 252 254 0 0 0 0 0 0 0 0 0 0 0 0 0 0 0 0 0 0 
213 212 92 214 0 0 0 0 0 0 0 0 0 0 0 0 0 0 0 0 7 7 0 0 0 0 0 0 0 0 0 0 0 0 0 0 0 0 0 0 
213 212 92 214 0 0 0 0 0 0 0 0 0 0 0 0 0 0 0 0 0 0 0 0 0 0 0 0 0 0 0 0 0 0 0 0 0 0 0 0 
213 212 92 214 0 0 0 0 0 0 0 0 0 0 0 0 0 0 0 0 0 0 0 0 0 0 0 0 0 0 0 0 0 0 0 0 0 0 0 0 
213 212 92 214 0 0 0 0 0 0 0 0 0 0 0 0 0 0 0 0 0 0 0 0 0 0 0 0 0 0 0 0 0 0 0 0 0 0 0 0 
213 212 92 214 0 0 0 0 0 0 0 0 0 0 0 0 0 0 0 0 0 0 0 0 0 0 0 0 0 0 0 0 0 0 0 0 172 173 173 173 
213 212 92 214 0 0 0 0 0 0 0 0 6 6 0 0 0 0 0 0 0 0 0 0 0 0 0 0 0 0 0 0 0 0 0 0 212 92 92 92 
213 212 92 214 0 0 0 0 0 0 0 0 172 174 0 0 0 0 0 0 0 0 0 0 0 0 0 0 0 0 0 0 0 0 0 0 212 92 92 92 
213 212 92 214 0 0 0 0 0 0 0 0 212 214 0 0 0 0 0 0 0 0 0 0 0 0 0 0 6 6 0 0 0 0 0 0 212 92 92 92 
213 212 92 214 0 0 0 0 0 0 0 0 212 214 0 0 0 0 0 0 0 0 0 0 0 0 0 0 172 174 0 0 0 0 0 0 212 92 92 92 
213 212 92 214 0 0 0 0 0 0 0 0 212 214 0 0 0 0 0 0 0 0 0 0 0 0 0 0 212 214 0 0 0 0 0 0 212 92 92 92 
213 212 92 214 0 0 0 0 0 0 0 0 212 214 0 0 0 0 0 0 0 0 0 0 0 0 0 0 212 214 0 0 0 0 0 0 212 92 92 92 
213 212 92 214 0 0 0 0 0 0 0 0 212 214 0 0 0 0 0 0 0 0 0 0 0 0 0 0 212 214 0 0 0 0 0 0 212 92 92 92 
213 212 92 214 0 0 0 0 0 0 0 0 212 214 0 0 0 0 0 0 6 6 0 0 0 0 0 0 212 214 0 0 0 0 0 0 212 92 92 92 
213 212 92 214 0 0 0 0 0 0 0 0 212 214 0 0 0 0 0 0 172 174 0 0 0 0 0 0 212 214 0 0 0 0 0 0 212 92 92 92 
213 212 92 214 172 174 0 0 0 0 0 0 212 214 0 0 0 0 0 0 212 214 0 0 0 0 0 0 212 214 0 0 0 0 0 0 212 92 92 92 
213 212 92 214 252 254 0 0 0 0 0 0 212 214 0 0 0 0 0 0 212 214 0 0 0 0 0 0 212 214 0 0 0 0 0 0 212 92 92 92 
1
4 2 10 0
