295 295 295 295 295 295 295 295 295 295 295 295 295 295 295 295 295 295 295 295 295 295 295 295 295 295 295 417 0 0 0 818 698 698 415 295 295 295 295 295 
295 295 295 295 295 295 295 295 295 295 295 295 295 295 295 295 295 295 295 295 295 295 295 295 295 295 295 417 0 0 0 818 698 698 415 295 295 295 295 295 
456 456 456 456 456 456 456 456 456 456 456 456 456 456 456 456 456 456 456 456 456 297 295 295 295 295 295 417 0 0 0 818 698 698 415 295 295 295 295 295 
0 0 0 818 698 698 698 698 698 698 698 698 698 698 698 698 698 698 698 698 698 415 295 295 295 295 295 417 0 0 0 818 698 698 415 295 295 295 295 295 
0 0 0 818 698 698 698 698 698 698 698 698 698 698 698 698 698 698 698 698 698 415 295 295 295 295 295 417 0 0 0 818 698 698 415 295 295 295 295 295 
0 0 0 858 859 859 859 859 859 859 859 859 859 859 859 859 859 859 859 859 859 415 295 295 295 295 295 417 0 0 0 818 698 698 415 295 295 295 295 295 
0 0 0 0 0 0 0 0 0 0 0 0 0 0 0 0 0 0 0 0 0 415 295 295 295 295 295 417 0 0 0 818 698 698 415 295 295 295 295 295 
0 0 0 0 0 0 0 0 0 0 0 0 0 0 0 0 0 0 0 0 0 415 295 295 295 295 295 417 0 0 0 818 698 698 415 295 295 295 295 295 
376 376 376 376 376 376 376 376 376 376 376 376 376 376 376 376 377 0 0 0 0 415 295 295 295 295 295 417 0 0 0 818 698 698 415 295 295 295 295 295 
295 295 295 295 295 295 295 295 295 295 295 295 295 295 295 295 417 0 0 0 0 415 295 295 295 295 295 417 0 0 0 818 698 698 415 295 295 295 295 295 
295 295 295 295 295 295 295 295 295 296 456 456 456 456 456 456 457 0 0 0 0 415 295 295 295 295 295 417 0 0 0 818 698 698 415 295 295 295 295 295 
295 295 295 295 295 295 295 295 295 417 9 9 9 9 9 9 9 0 0 0 0 415 295 295 295 295 295 417 0 0 0 818 698 698 415 295 295 295 295 295 
295 296 456 456 456 456 456 456 456 457 0 0 0 0 0 0 0 0 0 0 0 415 295 295 295 295 295 417 0 0 0 818 698 698 415 295 295 295 295 295 
295 417 0 0 0 0 0 0 0 0 0 0 0 0 0 0 0 0 0 0 0 415 295 295 295 295 295 417 0 0 0 818 698 698 415 295 295 295 295 295 
295 417 0 0 0 0 0 0 0 0 0 0 0 0 0 0 0 0 0 0 0 415 295 295 295 295 295 417 0 0 0 818 698 698 415 295 295 295 295 295 
295 417 0 0 0 0 0 0 0 0 0 0 0 0 0 0 0 0 0 0 0 415 295 295 295 295 295 417 0 0 0 818 698 698 415 295 295 295 295 295 
295 417 0 0 0 0 0 0 0 0 0 0 0 0 0 0 0 0 0 0 0 415 295 295 295 295 295 417 0 0 0 818 698 698 415 295 295 295 295 295 
295 417 0 0 0 0 0 0 0 0 0 0 0 0 0 0 0 0 0 0 0 415 295 295 295 295 295 417 0 0 0 818 698 698 415 295 295 295 295 295 
295 417 0 0 0 0 0 0 0 0 0 0 0 0 0 0 0 0 0 0 0 415 295 295 295 295 295 417 0 0 0 858 859 859 415 295 295 295 295 295 
295 417 0 0 0 0 0 0 0 0 0 0 0 0 0 0 0 0 0 0 0 415 295 295 295 295 295 417 0 0 0 0 0 0 415 295 295 295 295 295 
295 417 0 0 0 0 0 0 0 0 0 0 0 0 0 0 0 0 0 0 0 415 295 295 295 295 295 417 0 0 0 0 0 0 415 295 295 295 295 295 
295 417 0 0 0 0 0 0 0 0 0 0 0 0 0 778 779 779 779 779 779 415 295 295 295 295 295 417 779 779 779 780 0 0 415 295 295 295 295 295 
295 417 0 0 0 0 0 0 0 0 0 0 0 0 0 818 698 698 698 698 698 415 295 295 295 295 295 417 698 698 698 820 0 0 415 295 295 295 295 295 
295 417 0 0 0 0 0 0 0 0 0 0 0 0 0 0 0 0 0 0 0 415 295 295 295 295 295 417 698 698 698 820 0 0 415 295 295 295 295 295 
295 417 0 0 0 0 0 0 0 0 0 0 0 375 376 376 376 376 376 376 376 337 295 295 295 295 295 417 698 698 698 820 0 0 415 295 295 295 295 295 
295 417 0 0 0 0 8 8 8 8 8 8 8 415 295 295 295 295 295 295 295 295 295 295 295 295 295 417 698 698 698 820 0 0 415 295 295 295 295 295 
295 417 0 0 0 0 375 376 376 376 376 376 376 337 295 295 295 295 295 295 295 295 295 295 295 295 295 417 698 698 698 820 0 0 415 295 295 295 295 295 
295 417 779 779 779 779 415 295 295 295 295 295 295 295 295 295 295 295 295 295 295 295 295 295 295 295 295 417 698 698 698 820 0 0 415 295 295 295 295 295 
295 417 698 698 698 698 415 295 295 295 295 295 295 295 295 295 295 295 295 295 295 295 295 295 295 295 295 417 698 698 698 820 0 0 415 295 295 295 295 295 
4
2 13 2 7 4 0 0 320 240
13 23 2 8 4 0 0 320 240
18 21 10 1
3 14 10 0
