274 274 274 274 274 274 274 274 274 274 274 274 115 113 113 113 113 113 113 113 113 113 113 113 113 113 113 114 274 274 274 274 274 274 274 274 274 274 274 274 
0 0 0 0 0 0 0 0 0 0 0 0 273 115 113 113 113 113 113 113 113 113 113 113 113 113 114 275 0 0 0 0 0 0 0 0 0 0 0 0 
0 0 0 0 0 0 0 0 0 0 0 0 9 233 113 113 113 113 113 113 113 113 113 113 113 113 235 9 0 0 0 0 0 0 0 0 0 0 0 0 
0 0 0 0 0 0 0 0 0 0 0 0 0 273 115 113 113 113 113 113 113 113 113 113 113 114 275 0 0 0 0 0 0 0 0 0 0 0 0 0 
0 0 0 0 0 0 0 0 0 0 0 0 0 9 233 113 113 113 113 113 113 113 113 113 113 235 9 0 0 0 0 0 0 0 0 0 0 0 0 0 
0 0 0 0 0 0 0 0 0 0 0 0 0 0 273 115 113 113 113 113 113 113 113 113 114 275 0 0 0 0 0 0 0 0 0 0 0 0 0 0 
0 0 0 0 0 0 0 0 0 0 0 0 0 0 9 233 113 113 113 113 113 113 113 113 235 9 0 0 0 0 0 0 0 0 0 0 0 0 0 0 
8 8 8 8 8 8 8 8 8 0 0 0 0 0 0 273 115 113 113 113 113 113 113 114 275 0 0 0 0 0 0 8 8 8 8 8 8 8 8 8 
194 194 194 194 194 194 194 194 195 0 0 0 0 0 0 9 233 113 113 113 113 113 113 235 9 0 0 0 0 0 0 193 194 194 194 194 194 194 194 194 
113 113 113 113 113 113 113 113 235 8 0 0 0 0 0 0 273 115 113 113 113 113 114 275 0 0 0 0 0 0 8 233 113 113 113 113 113 113 113 113 
113 113 113 113 113 113 113 113 154 195 0 0 0 0 0 0 9 233 113 113 113 113 235 9 0 0 0 0 0 0 193 155 113 113 113 113 113 113 113 113 
113 113 113 113 113 113 113 113 113 235 8 0 0 0 0 0 0 273 115 113 113 114 275 0 0 0 0 0 0 8 233 113 113 113 113 113 113 113 113 113 
113 113 113 113 113 113 113 113 113 154 195 0 0 0 0 0 0 9 233 113 113 235 9 0 0 0 0 0 0 193 155 113 113 113 113 113 113 113 113 113 
113 113 113 113 113 113 113 113 113 113 235 8 0 0 0 0 0 0 273 115 114 275 0 0 0 0 0 0 8 233 113 113 113 113 113 113 113 113 113 113 
113 113 113 113 113 113 113 113 113 113 154 195 0 0 0 0 0 0 9 233 235 9 0 0 0 0 0 0 193 155 113 113 113 113 113 113 113 113 113 113 
113 113 113 113 113 113 113 113 113 113 113 235 8 0 0 0 0 0 0 273 275 0 0 0 0 0 0 8 233 113 113 113 113 113 113 113 113 113 113 113 
113 113 113 113 113 113 113 113 113 113 113 154 195 0 0 0 0 0 0 9 9 0 0 0 0 0 0 193 155 113 113 113 113 113 113 113 113 113 113 113 
113 113 113 113 113 113 113 113 113 113 113 113 235 8 0 0 0 0 0 0 0 0 0 0 0 0 8 233 113 113 113 113 113 113 113 113 113 113 113 113 
113 113 113 113 113 113 113 113 113 113 113 113 154 195 0 0 0 0 0 0 0 0 0 0 0 0 193 155 113 113 113 113 113 113 113 113 113 113 113 113 
113 113 113 113 113 113 113 113 113 113 113 113 113 235 8 0 0 0 0 0 0 0 0 0 0 8 233 113 113 113 113 113 113 113 113 113 113 113 113 113 
113 113 113 113 113 113 113 113 113 113 113 113 113 154 195 0 0 0 0 0 0 0 0 0 0 193 155 113 113 113 113 113 113 113 113 113 113 113 113 113 
113 113 113 113 113 113 113 113 113 113 113 113 113 113 235 8 0 0 0 0 0 0 0 0 8 233 113 113 113 113 113 113 113 113 113 113 113 113 113 113 
113 113 113 113 113 113 113 113 113 113 113 113 113 113 154 195 0 0 0 0 0 0 0 0 193 155 113 113 113 113 113 113 113 113 113 113 113 113 113 113 
113 113 113 113 113 113 113 113 113 113 113 113 113 113 113 235 8 0 0 0 0 0 0 8 233 113 113 113 113 113 113 113 113 113 113 113 113 113 113 113 
113 113 113 113 113 113 113 113 113 113 113 113 113 113 113 154 195 0 0 0 0 0 0 193 155 113 113 113 113 113 113 113 113 113 113 113 113 113 113 113 
113 113 113 113 113 113 113 113 113 113 113 113 113 113 113 113 235 8 0 0 0 0 8 233 113 113 113 113 113 113 113 113 113 113 113 113 113 113 113 113 
113 113 113 113 113 113 113 113 113 113 113 113 113 113 113 113 154 195 0 0 0 0 193 155 113 113 113 113 113 113 113 113 113 113 113 113 113 113 113 113 
113 113 113 113 113 113 113 113 113 113 113 113 113 113 113 113 113 235 8 8 8 8 233 113 113 113 113 113 113 113 113 113 113 113 113 113 113 113 113 113 
113 113 113 113 113 113 113 113 113 113 113 113 113 113 113 113 113 154 194 194 194 194 155 113 113 113 113 113 113 113 113 113 113 113 113 113 113 113 113 113 
7
18 25 2 4 0 0 0 320 240
3 2 10 0
35 2 10 0
0 1 2 7 4 0 0 320 240
8 1 2 5 4 0 0 320 240
28 1 2 8 4 0 0 320 240
36 1 2 6 4 0 0 320 240
