107 107 107 107 107 107 107 107 107 107 107 107 107 107 107 107 107 107 107 107 107 107 107 107 107 107 107 107 107 107 107 107 107 107 107 107 107 107 107 107 
107 107 107 107 107 107 107 107 107 107 107 107 107 107 107 107 107 107 107 107 107 107 107 107 107 107 107 107 107 107 107 107 107 107 107 107 107 107 107 107 
107 107 108 268 268 268 268 268 268 268 268 268 268 268 268 268 268 268 268 268 268 268 268 268 268 268 268 268 268 268 268 268 268 268 268 268 268 268 268 268 
107 107 229 689 811 0 0 0 0 0 0 0 0 0 0 0 0 0 0 0 0 0 0 0 0 0 0 0 0 0 0 0 0 0 0 0 0 0 0 0 
107 107 229 689 811 0 0 0 0 0 0 0 0 0 0 0 0 0 0 0 0 0 0 0 0 0 0 0 0 0 0 0 0 0 0 0 0 0 0 0 
107 107 229 689 811 0 0 0 0 0 0 0 0 0 0 0 0 0 0 0 0 0 0 0 0 0 0 0 0 0 0 0 0 0 0 0 0 0 0 0 
107 107 229 689 811 0 0 0 0 0 0 0 0 0 0 0 0 0 0 0 0 0 0 0 0 0 0 0 0 0 0 0 0 0 0 0 0 0 0 0 
107 107 229 689 811 0 0 187 188 188 188 188 188 188 188 188 188 188 188 188 188 188 188 188 188 188 188 188 188 188 188 188 188 189 0 0 0 0 0 0 
107 107 229 689 811 0 0 267 268 268 268 268 268 268 268 268 268 268 268 109 107 107 108 268 268 268 268 268 268 268 268 268 109 229 0 0 0 0 0 0 
107 107 229 689 811 0 0 9 9 9 9 9 9 9 9 9 9 9 9 227 107 107 229 9 9 9 9 9 9 9 9 9 227 229 0 0 0 0 0 0 
107 107 229 689 811 0 0 0 0 0 0 0 0 0 0 0 0 0 0 227 107 107 229 0 0 0 0 0 0 0 0 0 227 229 0 0 0 0 0 0 
107 107 229 689 811 0 0 0 0 0 0 0 0 0 0 0 0 0 0 267 268 268 269 0 0 0 0 0 0 0 0 0 227 229 0 0 0 0 0 0 
107 107 229 689 811 0 0 0 0 0 0 0 0 0 0 0 0 0 0 9 9 9 9 0 0 0 0 0 0 0 0 0 227 229 0 0 0 0 0 0 
107 107 229 689 811 0 0 0 0 0 0 0 0 0 0 0 0 0 0 0 0 0 0 0 0 0 0 0 0 0 0 0 227 229 0 0 0 0 0 0 
107 107 229 689 811 0 0 0 0 0 0 0 0 0 0 0 0 0 0 0 0 0 0 0 0 0 0 0 0 0 0 0 227 229 0 0 0 0 0 0 
107 107 229 689 811 0 0 0 0 0 0 0 0 0 0 0 0 0 0 0 0 0 0 0 0 0 0 0 0 0 0 0 227 229 0 0 0 0 0 0 
107 107 229 689 811 0 0 0 0 0 0 0 0 0 0 0 0 0 0 0 0 0 0 0 0 0 0 0 0 0 0 0 227 229 0 0 0 0 0 0 
107 107 229 850 851 0 0 0 0 0 0 0 0 0 0 0 0 0 0 0 0 0 0 0 0 0 0 0 0 0 0 0 227 229 0 0 0 0 0 0 
107 107 229 0 0 0 0 0 0 0 0 0 0 0 0 0 0 0 0 0 0 0 0 0 0 0 0 0 0 0 0 0 227 229 0 0 0 0 0 0 
107 107 229 0 0 0 0 0 0 0 0 0 8 8 8 8 0 0 0 0 0 0 0 0 0 0 0 0 0 0 0 0 227 229 0 0 0 0 0 0 
107 107 229 0 0 0 0 0 0 0 0 0 187 188 188 189 0 0 0 0 0 0 0 0 0 0 0 0 0 0 0 0 227 229 0 0 0 0 0 0 
107 107 229 0 0 0 0 0 0 0 0 0 227 107 107 229 0 0 0 0 0 0 0 0 0 0 0 0 0 0 0 0 227 148 188 188 188 188 188 188 
107 107 229 8 8 8 8 8 8 8 8 8 227 107 107 229 8 8 8 8 8 8 8 8 8 8 8 8 0 0 0 0 227 108 268 268 268 268 268 268 
107 107 148 188 188 188 188 188 188 188 188 188 149 107 107 148 188 188 188 188 188 188 188 188 188 188 188 189 0 0 0 0 227 229 0 0 0 0 0 0 
107 107 107 107 107 107 107 107 107 107 107 107 107 107 107 107 107 107 107 107 107 107 107 107 107 107 107 229 0 0 0 0 227 229 0 0 0 0 0 0 
107 107 107 107 107 107 107 107 107 107 107 107 107 107 107 107 107 107 107 107 107 107 107 107 107 107 107 229 0 0 0 0 227 229 0 0 0 0 0 0 
107 107 107 107 107 107 107 107 107 107 107 107 107 107 107 107 107 107 107 107 107 107 107 107 107 107 107 229 0 0 0 0 227 229 0 0 0 0 0 0 
107 107 107 107 107 107 107 107 107 107 107 107 107 107 107 107 107 107 107 107 107 107 107 107 107 107 107 229 0 0 0 0 227 229 0 0 0 0 0 0 
107 107 107 107 107 107 107 107 107 107 107 107 107 107 107 107 107 107 107 107 107 107 107 107 107 107 107 229 0 0 0 0 227 229 0 0 0 0 0 0 
5
8 5 10 1
26 11 2 4 0 0 0 320 240
19 20 2 4 0 0 0 320 240
12 11 2 4 0 0 0 320 240
5 20 2 4 0 0 0 320 240
