0 0 0 0 0 0 0 0 0 0 0 0 0 0 0 0 0 0 0 0 0 0 0 0 0 0 0 0 0 0 0 0 0 0 0 0 0 0 0 0 
0 0 0 0 0 0 0 0 0 0 0 0 0 0 0 0 0 0 0 0 0 0 0 0 0 0 0 0 0 0 0 0 0 0 0 0 0 0 0 0 
0 0 0 0 0 0 0 0 0 0 0 0 0 0 0 0 0 0 0 0 0 0 0 0 0 0 0 0 0 0 0 0 0 0 0 0 0 0 0 0 
0 0 0 0 0 0 0 0 0 0 0 0 0 0 0 0 0 0 0 0 0 0 0 0 0 0 0 0 0 0 0 0 0 0 0 0 0 0 0 0 
0 0 0 0 0 0 0 0 0 0 0 0 0 0 0 0 0 0 0 0 0 0 0 0 0 0 0 0 0 0 0 0 0 0 0 0 0 0 0 0 
0 0 0 0 0 0 0 0 0 0 0 0 0 0 0 0 0 0 0 0 0 0 0 0 0 0 0 0 0 0 0 0 0 0 0 0 0 0 0 0 
0 0 0 0 0 0 0 0 0 0 0 0 0 0 0 0 0 0 0 0 0 0 0 0 0 0 0 0 0 0 0 0 0 0 0 0 0 0 0 0 
0 0 0 0 0 0 0 0 0 0 0 0 0 0 0 0 0 0 0 0 0 0 0 0 0 0 0 0 0 0 0 0 0 0 0 0 0 0 0 0 
0 0 0 0 0 0 0 0 0 0 0 0 0 0 0 0 0 0 0 0 0 0 0 0 0 0 0 0 0 0 0 0 0 0 0 0 0 0 0 0 
0 0 0 0 0 0 0 0 0 0 0 0 0 0 0 0 0 0 0 0 0 0 0 0 0 0 0 0 0 0 0 0 0 0 0 0 0 0 0 0 
0 0 0 0 0 0 0 0 0 0 0 0 0 0 0 0 0 0 0 0 0 0 0 0 0 0 0 0 0 0 0 0 0 0 0 0 0 0 0 0 
0 0 0 0 0 0 0 0 0 0 0 0 0 0 0 0 0 0 0 0 0 0 0 0 0 0 0 0 0 0 0 0 0 0 0 0 0 0 0 0 
0 0 0 0 0 0 0 0 0 0 0 0 0 0 0 0 0 0 0 0 0 0 0 0 0 0 0 0 0 0 0 0 0 0 0 0 0 0 0 0 
0 0 0 0 0 0 0 0 0 0 0 0 0 0 0 0 0 0 169 170 170 171 0 0 0 0 0 0 0 0 0 0 0 0 0 0 0 0 0 0 
0 0 0 0 0 0 169 170 170 171 0 0 0 0 0 0 0 0 209 89 89 211 0 0 0 0 0 0 0 0 169 170 170 171 0 0 0 0 0 0 
0 0 0 0 0 0 209 89 89 211 0 0 0 0 0 0 0 0 209 89 89 211 0 0 0 0 0 0 0 0 209 89 89 211 0 0 0 0 0 0 
0 0 0 0 0 0 249 91 90 251 0 0 0 0 0 0 0 0 249 91 90 251 0 0 0 0 0 0 0 0 249 91 90 251 0 0 0 0 0 0 
0 0 0 0 0 0 0 249 251 0 0 0 0 0 0 0 0 0 0 249 251 0 0 0 0 0 0 0 0 0 0 249 251 0 0 0 0 0 0 0 
0 0 0 0 0 0 0 0 0 0 0 0 0 0 0 0 0 0 0 0 0 0 0 0 0 0 0 0 0 0 0 0 0 0 0 0 0 0 0 0 
0 0 0 0 0 0 0 0 0 0 0 0 0 0 0 0 0 0 0 0 0 0 0 0 0 0 0 0 0 0 0 0 0 0 0 0 0 0 0 0 
0 0 0 0 0 0 0 169 171 0 0 0 0 0 0 0 0 0 0 169 171 0 0 0 0 0 0 0 0 0 0 169 171 0 0 0 0 0 0 0 
0 0 0 0 0 0 169 131 130 171 0 0 0 0 0 0 0 0 169 131 130 171 0 0 0 0 0 0 0 0 169 131 130 171 0 0 0 0 0 0 
0 0 0 0 0 0 209 89 89 211 0 0 0 0 0 0 0 0 209 89 89 211 0 0 0 0 0 0 0 0 209 89 89 211 0 0 0 0 0 0 
0 0 0 0 0 0 209 89 89 211 0 0 0 0 0 0 0 0 209 89 89 211 0 0 0 0 0 0 0 0 209 89 89 211 0 0 0 0 0 0 
0 0 0 0 0 0 209 89 89 211 0 0 0 0 0 0 0 0 209 89 89 211 0 0 0 0 0 0 0 0 209 89 89 211 0 0 0 0 0 0 
0 0 0 0 0 0 209 89 89 211 0 0 0 0 0 0 0 0 209 89 89 211 0 0 0 0 0 0 0 0 209 89 89 211 0 0 0 0 0 0 
8 8 8 8 8 8 209 89 89 211 8 8 8 8 8 8 8 8 209 89 89 211 8 8 8 8 8 8 8 8 209 89 89 211 8 8 8 8 8 8 
170 170 170 170 170 170 131 89 89 130 170 170 170 170 170 170 170 170 131 89 89 130 170 170 170 170 170 170 170 170 131 89 89 130 170 170 170 170 170 170 
89 89 89 89 89 89 89 89 89 89 89 89 89 89 89 89 89 89 89 89 89 89 89 89 89 89 89 89 89 89 89 89 89 89 89 89 89 89 89 89 
0
