292 292 292 292 414 59 0 0 0 0 0 0 60 427 59 0 0 0 0 0 0 60 427 59 0 0 0 0 0 0 0 0 0 0 0 0 0 0 0 0 
292 292 292 292 414 59 0 0 0 0 0 0 60 427 59 0 0 0 0 0 0 60 427 59 0 0 0 0 0 0 0 0 0 0 0 0 0 0 0 0 
292 292 292 292 414 59 0 0 0 0 0 0 60 427 59 0 0 0 0 0 0 60 427 59 0 0 0 0 0 0 0 0 0 0 0 0 0 0 0 0 
292 292 292 292 414 59 0 0 0 0 0 0 60 427 59 0 0 0 0 0 0 60 427 59 0 0 0 0 0 0 0 0 0 0 0 0 0 0 0 0 
292 292 292 292 414 59 0 0 0 0 0 0 60 427 59 0 0 0 0 0 0 60 468 373 373 373 373 373 373 373 373 373 373 373 373 373 373 373 373 373 
292 292 292 292 414 59 0 0 0 0 0 0 60 427 59 0 0 0 0 0 0 60 412 292 292 292 292 292 292 292 292 292 292 292 292 292 292 292 292 292 
292 292 292 292 414 59 0 0 0 0 0 0 60 427 59 0 0 0 0 0 0 60 428 453 453 453 453 453 453 453 453 453 453 453 453 453 453 453 453 453 
292 292 292 292 414 59 0 0 0 0 0 0 60 427 59 0 0 0 0 0 0 60 427 59 0 0 0 0 0 0 0 0 0 0 0 0 0 0 0 0 
292 292 292 292 414 59 0 0 0 0 0 0 60 427 59 0 0 0 0 0 0 60 427 59 0 0 0 0 0 0 0 0 0 0 0 0 0 0 0 0 
292 292 292 292 414 59 0 0 0 0 0 0 60 427 59 0 0 0 0 0 0 60 427 59 0 0 0 0 0 0 0 0 0 0 0 0 0 0 0 0 
292 292 292 292 414 59 0 0 0 0 0 0 60 427 59 0 0 0 0 0 0 60 427 59 0 0 0 0 0 0 0 0 0 0 0 0 0 0 0 0 
292 292 292 292 414 59 0 0 0 0 0 0 60 427 59 0 0 0 0 0 0 60 427 59 0 0 0 0 0 0 0 0 0 0 0 0 0 0 0 0 
292 292 292 292 414 59 0 0 0 0 0 0 60 467 59 0 0 0 0 0 0 60 467 59 0 0 0 0 0 0 0 0 0 0 0 0 0 0 0 0 
292 292 292 292 414 59 0 0 0 0 0 0 0 72 0 0 0 0 0 0 0 0 72 0 0 0 0 0 0 0 0 0 0 0 0 0 0 0 0 0 
292 292 292 292 414 59 0 0 0 0 0 0 0 0 0 0 0 0 0 0 0 0 0 0 0 0 0 0 0 0 0 0 372 373 373 373 373 373 373 373 
292 292 292 292 414 59 0 0 0 0 0 0 0 0 0 0 0 0 0 0 0 0 0 0 0 0 0 0 0 0 0 0 412 292 292 292 292 292 292 292 
292 292 292 292 414 59 0 0 0 0 0 0 0 0 0 0 0 0 0 0 0 0 0 0 0 0 0 0 0 0 0 60 412 292 292 292 292 292 292 292 
292 292 292 292 414 59 0 0 0 0 0 0 0 0 0 0 0 0 0 0 0 0 0 0 0 0 0 0 0 0 0 60 412 292 292 292 292 292 292 292 
292 292 292 292 414 59 0 0 0 0 0 0 0 0 0 0 0 0 0 0 0 0 0 0 0 0 0 0 0 0 0 60 412 292 292 292 292 292 292 292 
292 292 292 292 414 59 0 0 0 0 0 0 0 0 0 0 0 0 0 0 0 0 0 0 0 0 0 0 0 0 0 60 412 292 292 292 292 292 292 292 
292 292 292 292 414 59 0 0 0 0 0 0 0 0 0 0 0 0 0 0 0 0 0 0 0 0 0 0 0 0 0 60 412 292 292 292 292 292 292 292 
292 292 292 292 414 59 0 0 0 0 0 0 0 0 0 0 0 0 0 0 0 0 0 0 0 0 0 0 0 0 0 60 412 292 292 292 292 292 292 292 
292 292 292 292 333 374 71 71 71 71 71 71 71 71 71 71 71 71 71 71 71 71 71 71 71 71 71 71 71 71 71 372 334 292 292 292 292 292 292 292 
292 292 292 292 292 333 373 373 373 373 373 373 373 373 373 373 373 373 373 373 373 373 373 373 373 373 373 373 373 373 373 334 292 292 292 292 292 292 292 292 
292 292 292 292 292 292 292 292 292 292 292 292 292 292 292 292 292 292 292 292 292 292 292 292 292 292 292 292 292 292 292 292 292 292 292 292 292 292 292 292 
292 292 292 292 292 292 292 292 292 292 292 292 292 292 292 292 292 292 292 292 292 292 292 292 292 292 292 292 292 292 292 292 292 292 292 292 292 292 292 292 
292 292 292 292 292 292 292 292 292 292 292 292 292 292 292 292 292 292 292 292 292 292 292 292 292 292 292 292 292 292 292 292 292 292 292 292 292 292 292 292 
292 292 292 292 292 292 292 292 292 292 292 292 292 292 292 292 292 292 292 292 292 292 292 292 292 292 292 292 292 292 292 292 292 292 292 292 292 292 292 292 
292 292 292 292 292 292 292 292 292 292 292 292 292 292 292 292 292 292 292 292 292 292 292 292 292 292 292 292 292 292 292 292 292 292 292 292 292 292 292 292 
2
6 19 11 200
27 7 10 0
