280 280 280 280 280 280 280 280 280 280 280 280 280 280 280 280 280 280 280 280 280 280 280 280 280 280 280 280 280 280 280 280 280 280 280 280 280 280 280 280 
281 441 441 441 441 282 281 441 441 441 441 441 441 441 441 441 441 441 441 441 441 441 441 441 441 441 441 441 441 441 441 441 441 441 441 441 441 282 280 280 
402 0 0 0 0 400 402 64 64 64 64 64 64 64 64 64 64 64 64 64 64 64 64 64 64 64 64 64 64 64 64 64 64 64 64 64 64 440 282 280 
402 0 0 0 0 400 402 0 0 0 0 0 0 0 0 0 0 0 0 0 0 0 0 0 0 0 0 0 0 0 0 0 0 0 0 0 0 52 400 280 
402 0 0 0 0 400 402 0 0 0 0 0 0 0 0 0 0 0 0 0 0 0 0 0 0 0 0 0 0 0 0 0 0 0 0 0 0 52 400 280 
402 0 0 0 0 440 442 0 0 0 0 0 0 0 0 0 0 0 0 0 0 0 0 0 0 0 0 0 0 0 0 0 0 0 0 0 0 52 400 280 
402 0 0 0 0 0 0 0 0 0 0 0 0 0 0 0 0 0 0 0 0 0 0 0 0 0 0 0 0 0 0 0 0 0 0 0 0 52 400 280 
402 0 0 0 0 0 0 0 0 0 0 0 0 0 0 0 0 0 0 0 0 0 0 0 0 0 0 0 0 0 0 0 0 0 0 0 0 52 400 280 
402 0 0 0 0 0 0 0 0 0 0 0 0 0 0 0 0 0 0 0 0 0 0 0 0 0 0 0 0 0 0 0 0 0 0 0 0 52 400 280 
402 0 0 0 0 0 0 0 0 0 0 0 0 0 0 0 0 0 0 0 0 0 0 0 0 0 0 0 0 0 0 0 0 0 0 0 0 52 400 280 
402 0 0 0 0 0 0 0 0 0 0 0 0 0 0 0 0 0 0 0 0 0 0 0 0 0 0 0 0 0 0 0 0 0 0 0 0 52 400 280 
321 361 361 361 361 361 361 361 361 362 0 0 0 0 0 0 0 0 0 0 0 0 0 63 0 0 360 361 361 361 345 306 0 0 0 0 0 52 400 280 
280 280 280 280 280 280 280 280 280 402 0 0 0 0 0 0 0 0 0 0 0 0 0 384 0 0 400 280 280 280 402 51 0 0 0 0 0 52 400 280 
280 280 280 280 280 280 280 280 280 402 0 0 63 0 0 0 0 0 0 0 0 0 0 424 0 0 400 280 280 280 402 51 0 0 0 0 0 52 400 280 
280 280 280 280 280 280 280 280 280 402 0 0 384 0 0 0 0 0 0 0 0 0 0 424 0 0 400 280 280 280 402 51 0 0 0 0 0 52 400 280 
280 280 280 280 280 280 280 280 280 402 0 0 424 0 0 0 0 0 0 0 0 0 0 424 0 0 400 280 280 280 402 51 0 0 0 0 0 52 400 280 
280 280 280 280 280 280 280 280 280 402 0 0 424 0 0 0 0 0 0 0 0 0 0 424 0 0 400 280 280 280 402 51 0 0 0 0 0 52 400 280 
280 280 280 280 280 280 280 280 280 402 0 0 424 0 0 0 0 0 0 0 0 0 0 424 0 0 400 280 280 280 402 51 0 0 0 0 0 52 400 280 
280 280 280 280 280 280 280 280 280 402 63 63 424 63 63 63 63 63 63 63 63 63 63 424 63 63 400 280 280 280 402 51 0 0 0 0 0 52 400 280 
280 280 280 280 280 280 280 280 280 321 361 361 479 361 361 361 361 361 361 361 361 361 361 479 361 361 322 280 280 280 402 51 0 0 0 0 0 52 400 280 
280 280 280 280 280 280 280 280 280 280 280 280 280 280 280 280 280 280 280 280 280 280 280 280 280 280 280 280 280 280 402 51 0 0 0 0 0 52 400 280 
280 280 280 280 280 280 280 280 281 441 441 441 441 441 441 441 441 441 441 441 441 441 441 441 441 441 441 441 441 441 385 306 0 0 0 0 0 52 400 280 
280 280 280 280 280 280 280 280 402 0 0 0 0 0 0 0 0 0 0 0 0 0 0 0 0 0 0 0 0 0 0 0 0 0 0 0 0 52 400 280 
280 280 280 280 280 280 280 280 402 0 0 0 0 0 0 0 0 0 0 0 0 0 0 0 0 0 0 0 0 0 0 0 0 0 0 0 0 52 400 280 
280 280 280 280 280 280 280 280 402 0 0 0 0 0 0 0 0 0 0 0 0 0 0 0 0 0 0 0 0 0 0 0 0 0 0 0 0 52 400 280 
280 280 280 280 280 280 280 280 402 0 0 0 0 0 0 0 0 0 0 0 0 0 0 0 0 0 0 0 0 0 0 0 0 0 0 0 0 52 400 280 
280 280 280 280 280 280 280 280 402 0 0 0 0 0 360 361 361 361 361 361 361 361 361 361 361 361 361 361 361 361 361 361 361 361 361 361 361 361 322 280 
280 280 280 280 280 280 280 280 402 0 0 0 0 0 400 280 280 280 280 280 280 280 280 280 280 280 280 280 280 280 280 280 280 280 280 280 280 280 280 280 
280 280 280 280 280 280 280 280 402 0 0 0 0 0 400 280 280 280 280 280 280 280 280 280 280 280 280 280 280 280 280 280 280 280 280 280 280 280 280 280 
7
33 3 12 184
2 3 9
23 3 12 64
13 15 11 80
6 9 10 1
28 9 10 1
12 3 12 80
