286 286 286 286 286 286 286 286 286 286 286 286 286 286 286 286 408 55 0 0 0 0 0 56 406 286 286 286 286 286 286 286 286 286 286 286 286 286 286 286 
286 286 286 286 286 286 286 286 286 286 286 286 286 286 286 286 408 55 0 0 0 0 0 56 406 286 286 286 286 286 286 286 286 286 286 286 286 286 286 286 
286 286 286 286 286 286 287 447 447 447 288 286 286 286 286 286 408 55 0 0 0 0 0 56 406 286 286 286 286 286 287 447 447 447 288 286 286 286 286 286 
286 286 286 286 286 286 408 68 68 68 406 286 286 286 286 286 408 55 0 0 0 0 0 56 406 286 286 286 286 286 408 68 68 68 406 286 286 286 286 286 
286 286 286 286 286 286 408 0 0 0 446 288 286 286 286 286 408 55 0 0 0 0 0 56 406 286 286 286 286 287 448 0 0 0 406 286 286 286 286 286 
286 286 286 286 286 286 408 0 0 0 68 406 286 286 286 286 408 55 0 0 0 0 0 56 406 286 286 286 286 408 68 0 0 0 406 286 286 286 286 286 
286 286 286 286 286 286 408 0 0 0 0 446 447 447 447 447 448 55 0 0 0 0 0 56 446 447 447 447 447 448 0 0 0 0 406 286 286 286 286 286 
286 286 286 286 286 286 408 0 0 0 0 68 68 68 68 68 68 0 0 0 0 0 0 0 68 68 68 68 68 68 0 0 0 0 406 286 286 286 286 286 
286 286 286 286 286 286 408 0 0 0 0 0 0 0 0 0 0 0 0 0 0 0 0 0 0 0 0 0 0 0 0 0 0 0 406 286 286 286 286 286 
286 286 286 286 286 286 408 0 0 0 0 0 0 0 0 0 0 0 0 0 0 0 0 0 0 0 0 0 0 0 0 0 0 0 406 286 286 286 286 286 
286 286 286 286 286 286 408 0 0 0 0 0 0 0 0 0 0 0 0 0 0 0 0 0 0 0 0 0 0 0 0 0 0 0 406 286 286 286 286 286 
286 286 286 286 286 286 408 0 0 0 0 0 0 0 0 0 0 0 366 367 367 367 368 0 0 0 0 0 0 0 0 0 0 0 406 286 286 286 286 286 
286 286 286 286 286 286 408 0 0 0 0 0 0 0 0 0 366 367 328 286 286 286 327 367 368 0 0 0 0 0 0 0 0 0 406 286 286 286 286 286 
286 286 286 286 286 286 408 0 0 0 0 0 0 366 367 367 328 286 286 286 286 286 286 286 327 367 367 368 0 0 0 0 0 0 406 286 286 286 286 286 
286 286 286 286 286 286 408 0 0 0 0 0 0 406 286 286 286 286 286 286 286 286 286 286 286 286 286 408 0 0 0 0 0 0 406 286 286 286 286 286 
286 286 286 286 286 286 408 0 0 0 0 0 0 446 447 288 286 286 286 286 286 286 286 286 286 287 447 448 0 0 0 0 0 0 406 286 286 286 286 286 
286 286 286 286 286 286 408 0 0 0 0 0 0 68 68 446 447 288 286 286 286 286 286 287 447 448 68 68 0 0 0 0 0 0 406 286 286 286 286 286 
286 286 286 286 286 286 327 368 0 0 0 0 0 0 0 68 68 446 447 288 286 287 447 448 68 68 0 0 0 0 0 0 0 366 328 286 286 286 286 286 
286 286 286 286 286 286 286 408 0 0 0 0 0 0 0 0 0 68 68 446 447 448 68 68 0 0 0 0 0 0 0 0 0 406 286 286 286 286 286 286 
286 286 286 286 286 286 286 327 368 0 0 0 0 0 0 0 0 0 0 68 68 68 0 0 0 0 0 0 0 0 0 0 366 328 286 286 286 286 286 286 
286 286 286 286 286 286 286 286 408 0 0 0 0 0 0 0 0 0 0 0 0 0 0 0 0 0 0 0 0 0 0 0 406 286 286 286 286 286 286 286 
286 286 286 286 286 286 286 286 327 368 0 0 0 0 0 0 0 0 0 0 0 0 0 0 0 0 0 0 0 0 0 366 328 286 286 286 286 286 286 286 
286 286 286 286 286 286 286 286 286 408 0 0 0 0 0 0 0 0 0 0 0 0 0 0 0 0 0 0 0 0 0 406 286 286 286 286 286 286 286 286 
286 286 286 286 286 286 286 286 286 327 367 368 0 0 0 0 0 0 0 0 0 0 0 0 0 0 0 0 0 366 367 328 286 286 286 286 286 286 286 286 
286 286 286 286 286 286 286 286 286 286 286 327 367 368 0 0 0 0 0 0 0 0 0 0 0 0 0 366 367 328 286 286 286 286 286 286 286 286 286 286 
286 286 286 286 286 286 286 286 286 286 286 286 286 327 367 368 0 0 0 0 0 0 0 0 0 366 367 328 286 286 286 286 286 286 286 286 286 286 286 286 
286 286 286 286 286 286 286 286 286 286 286 286 286 286 286 327 367 368 0 0 0 0 0 366 367 328 286 286 286 286 286 286 286 286 286 286 286 286 286 286 
286 286 286 286 286 286 286 286 286 286 286 286 286 286 286 286 286 408 0 0 0 0 0 406 286 286 286 286 286 286 286 286 286 286 286 286 286 286 286 286 
286 286 286 286 286 286 286 286 286 286 286 286 286 286 286 286 286 408 0 0 0 0 0 406 286 286 286 286 286 286 286 286 286 286 286 286 286 286 286 286 
0
