0 0 0 0 0 0 0 0 0 56 406 286 408 55 0 0 0 0 0 0 0 0 0 0 0 0 56 406 286 408 55 0 0 0 0 0 0 0 0 0 
0 0 0 0 0 0 0 0 0 56 406 286 408 55 0 0 0 0 0 0 0 0 0 0 0 0 56 406 286 408 55 0 0 0 0 0 0 0 0 0 
0 0 0 0 0 0 0 0 0 56 406 286 408 55 0 0 0 0 0 0 0 0 0 0 0 0 56 446 399 448 55 0 0 0 0 0 0 0 0 0 
0 0 0 0 0 0 0 0 0 56 406 286 408 55 0 0 0 0 0 0 0 0 0 0 0 0 0 68 470 68 0 0 0 0 0 0 0 0 0 0 
0 0 0 0 0 0 0 0 0 56 406 286 408 55 0 0 0 0 0 0 0 0 0 0 0 0 0 0 68 0 0 0 0 0 0 0 0 0 0 0 
0 0 0 0 0 0 0 0 0 56 406 286 408 55 0 0 0 0 0 0 0 0 0 0 0 0 0 0 0 0 0 0 0 0 0 0 0 0 0 0 
0 0 0 0 0 0 0 0 0 56 406 286 408 55 0 0 0 0 0 0 0 0 0 0 0 0 0 0 0 0 0 0 0 0 0 0 0 0 0 0 
0 0 0 0 0 0 0 0 0 56 406 286 408 55 0 0 0 0 0 0 0 0 0 0 0 0 0 0 0 0 0 0 0 0 0 0 0 0 0 0 
0 0 0 0 0 0 0 0 0 56 406 286 408 55 0 0 0 0 0 0 0 0 0 0 0 0 0 0 0 0 0 0 0 0 0 0 0 0 0 0 
0 0 0 0 0 0 0 0 0 56 406 286 408 55 0 0 0 0 0 0 0 0 0 0 0 0 0 0 0 0 0 0 0 0 0 0 0 0 0 0 
0 0 0 0 0 0 0 0 0 56 406 286 408 55 0 0 0 0 0 0 0 0 0 0 0 0 0 0 0 0 0 0 0 0 0 0 0 0 0 0 
0 0 0 0 0 0 0 0 0 56 406 286 408 55 0 0 0 0 0 0 0 0 0 0 0 0 0 0 0 0 0 0 0 0 0 0 0 0 0 0 
0 0 0 0 0 0 0 0 0 56 406 286 408 55 0 0 0 0 0 0 0 0 0 0 0 0 0 0 0 0 0 0 0 0 0 0 0 0 0 0 
0 0 0 0 0 0 0 0 0 56 406 286 408 55 0 0 0 0 0 0 0 0 0 0 0 0 0 0 0 0 0 0 0 0 0 0 0 0 0 0 
0 0 0 0 0 0 0 0 0 56 406 286 408 55 0 0 0 0 0 0 0 0 0 0 0 0 0 0 0 0 0 0 0 0 0 0 0 0 0 0 
0 0 0 0 0 0 0 0 0 56 406 286 408 55 0 0 0 0 0 0 0 0 0 0 0 0 0 0 0 0 0 0 0 0 0 0 0 0 0 0 
0 0 0 0 0 0 0 0 0 56 406 286 408 55 0 0 0 0 0 0 0 0 0 0 0 0 0 0 0 0 0 0 0 0 0 0 0 0 0 0 
0 0 0 0 0 0 0 0 0 56 406 286 408 55 0 0 0 0 0 0 0 0 0 0 0 0 0 0 0 0 0 0 0 0 0 0 0 0 0 0 
0 0 0 0 0 0 0 0 0 56 406 286 408 55 0 0 0 0 0 0 0 0 0 0 0 0 0 0 67 0 0 0 0 0 0 0 0 0 0 0 
0 0 0 0 0 0 0 0 0 56 406 286 408 55 0 0 0 0 0 0 0 0 0 0 0 0 0 67 390 67 0 0 0 0 0 0 0 0 0 0 
0 0 0 0 0 0 0 0 0 56 406 286 408 55 0 0 0 0 0 0 0 0 0 0 0 0 56 366 350 368 55 0 0 0 0 0 0 0 0 0 
0 0 0 0 0 0 0 0 0 56 406 286 408 55 0 0 0 0 0 0 0 0 0 0 0 0 56 406 286 408 55 0 0 0 0 0 0 0 0 0 
0 0 0 0 0 0 0 0 0 56 406 286 408 55 0 0 0 0 0 0 0 0 0 0 0 0 56 406 286 408 55 0 0 0 0 0 0 0 0 0 
0 0 0 0 0 0 0 0 0 56 406 286 408 55 0 0 0 0 0 0 0 0 0 0 0 0 56 406 286 408 55 0 0 0 0 0 0 0 0 0 
0 0 0 0 0 0 0 0 0 56 406 286 408 55 0 0 0 0 0 0 0 0 0 0 0 0 56 406 286 408 55 0 0 0 0 0 0 0 0 0 
67 67 67 67 67 67 67 67 67 366 328 286 327 368 67 67 67 67 67 67 67 67 67 67 67 67 366 328 286 327 368 67 67 67 67 67 67 67 67 67 
367 367 367 367 367 367 367 367 367 328 286 286 286 327 367 367 367 367 367 367 367 367 367 367 367 367 328 286 286 286 327 367 367 367 367 367 367 367 367 367 
286 286 286 286 286 286 286 286 286 286 286 286 286 286 286 286 286 286 286 286 286 286 286 286 286 286 286 286 286 286 286 286 286 286 286 286 286 286 286 286 
286 286 286 286 286 286 286 286 286 286 286 286 286 286 286 286 286 286 286 286 286 286 286 286 286 286 286 286 286 286 286 286 286 286 286 286 286 286 286 286 
3
0 22 11 72
14 22 11 96
31 22 11 80
