298 259 0 0 0 0 0 0 0 0 0 0 0 0 0 0 0 0 0 0 0 218 298 259 0 0 0 0 0 0 0 0 0 0 0 0 218 219 0 0 
259 0 0 0 0 0 0 0 0 0 0 0 0 0 0 0 0 0 0 0 218 298 259 0 0 0 0 0 0 0 0 0 0 0 0 218 298 298 219 0 
0 0 0 0 0 0 0 0 0 0 0 0 0 0 0 0 0 0 0 218 298 259 0 0 0 0 0 0 0 0 0 0 0 0 218 298 298 298 298 219 
0 218 219 0 0 0 0 0 0 218 219 0 0 0 0 0 0 0 0 258 298 219 0 0 0 0 0 0 0 0 0 0 0 218 298 298 298 298 298 259 
218 298 298 219 0 0 0 0 218 298 298 219 0 0 0 0 0 0 0 0 258 298 219 0 0 0 0 0 0 0 0 0 218 298 298 298 298 298 259 0 
298 298 298 298 219 0 0 218 298 298 298 298 219 0 0 0 0 0 0 0 0 258 298 219 0 0 0 0 0 0 0 218 298 298 298 298 298 259 0 0 
298 298 298 298 298 219 218 298 298 298 298 298 298 219 0 0 0 0 0 0 0 0 258 298 219 0 0 0 0 0 0 258 298 298 298 298 298 219 0 0 
298 298 298 298 298 298 298 298 298 298 298 298 298 298 219 0 0 0 0 0 0 0 0 258 298 219 0 0 0 0 0 0 258 298 298 298 298 298 219 0 
298 298 298 298 298 298 298 298 259 258 298 298 259 258 298 219 0 0 0 0 0 0 0 0 258 298 219 0 0 0 0 0 0 258 298 298 298 298 298 219 
298 298 298 298 298 298 298 259 0 0 258 259 0 0 258 259 0 0 0 0 0 0 218 219 218 298 298 219 0 0 0 0 0 0 258 298 298 298 298 298 
298 298 298 298 298 298 259 0 218 219 0 0 0 0 0 0 0 0 0 0 0 218 298 298 298 298 298 298 219 0 0 0 0 0 0 258 298 298 298 298 
298 298 298 298 298 298 219 218 298 259 0 0 0 0 0 0 0 0 0 0 0 258 298 298 298 138 258 298 298 219 0 0 0 0 0 0 258 298 298 298 
298 298 298 298 298 298 298 298 259 0 0 0 0 0 0 0 0 0 0 0 0 0 258 298 298 178 0 258 298 298 219 0 0 0 0 0 0 258 298 298 
258 298 298 298 298 298 298 259 0 0 0 0 0 0 0 0 0 0 0 0 0 0 218 298 298 138 0 179 298 298 298 219 0 0 0 0 0 0 258 298 
0 258 298 298 298 298 259 0 0 0 0 0 0 0 0 0 0 0 0 218 219 218 298 298 138 0 0 139 298 298 298 259 0 0 0 0 0 0 0 258 
0 0 258 298 298 298 219 0 0 0 0 0 218 219 0 0 0 0 218 298 298 298 298 138 0 0 0 0 139 298 259 0 218 219 0 0 0 0 0 0 
0 0 0 258 298 298 298 219 0 0 0 218 298 259 0 0 0 0 258 298 298 298 298 178 179 178 0 0 179 298 219 218 298 298 219 0 0 0 0 0 
0 0 0 0 258 298 298 298 219 0 0 258 298 219 0 0 0 0 218 298 298 298 298 298 298 298 178 179 298 298 298 298 298 298 259 0 0 0 0 0 
0 0 0 0 218 298 298 298 298 219 0 0 258 298 219 218 219 218 298 298 298 298 298 298 298 298 298 298 298 298 298 298 298 259 0 0 0 0 0 0 
0 0 0 218 298 298 298 298 298 298 219 0 0 258 298 298 298 298 298 298 298 298 259 258 298 298 298 298 298 298 298 298 259 0 0 0 0 0 0 218 
0 0 218 298 298 298 259 258 298 298 298 219 0 0 258 298 298 298 298 298 298 259 0 0 258 298 298 298 298 298 298 298 219 0 0 0 0 0 218 298 
0 0 258 298 298 259 0 0 258 298 298 298 219 0 0 258 298 298 298 298 298 219 0 0 0 258 259 258 298 298 298 298 298 219 0 0 0 0 258 298 
0 0 0 258 259 0 0 0 0 258 259 258 298 219 0 0 258 298 298 298 298 298 219 0 0 0 0 0 258 298 298 259 258 298 219 0 0 0 0 258 
0 0 0 0 0 0 218 219 0 0 0 0 258 298 219 0 0 258 259 258 298 298 298 219 0 0 0 0 0 258 259 0 0 258 298 219 0 0 0 0 
0 0 0 0 0 0 258 298 219 0 0 0 0 258 298 219 0 0 0 218 298 298 298 259 0 0 0 0 0 0 0 0 0 0 258 259 0 0 0 0 
0 0 0 0 0 0 218 298 298 219 218 219 0 0 258 259 0 0 0 258 298 298 259 0 0 218 219 0 0 0 0 218 219 0 0 0 0 0 0 0 
0 0 0 0 0 218 298 298 298 298 298 259 0 0 0 0 0 0 0 0 258 298 219 0 0 258 298 219 0 0 218 298 298 219 0 0 218 219 0 0 
0 0 0 0 218 298 298 298 298 298 259 0 0 0 0 0 0 0 0 0 0 258 298 219 0 0 258 298 219 218 298 259 258 298 219 218 298 298 219 0 
0 0 0 218 298 298 298 298 298 298 219 0 0 0 0 0 0 0 0 0 0 0 258 298 219 0 0 258 298 298 259 0 0 258 298 298 298 298 298 219 
0 0 0 258 298 298 259 258 298 298 298 219 0 0 0 0 0 0 0 0 0 0 0 258 298 219 0 0 258 259 0 0 0 0 258 298 298 298 298 298 
219 0 0 0 258 259 0 0 258 298 298 298 219 0 0 0 0 0 0 0 0 0 0 0 258 298 219 0 0 0 0 0 0 0 218 298 298 298 298 298 
298 219 0 0 0 0 0 0 218 298 298 298 298 219 0 0 0 0 218 219 0 0 0 0 0 258 298 219 0 218 219 0 0 218 298 298 298 298 298 298 
258 298 219 0 0 0 0 218 298 298 298 298 298 298 219 0 0 0 258 298 219 218 219 0 0 218 298 259 0 258 298 219 218 298 298 298 259 258 298 298 
0 258 298 219 0 0 218 298 298 298 259 258 298 298 259 0 0 0 0 258 298 298 298 219 218 298 259 0 0 0 258 298 298 298 298 259 0 218 298 298 
0 218 298 298 219 218 298 298 298 259 0 0 258 259 0 0 0 0 0 218 298 298 298 298 298 259 0 0 0 0 0 258 298 298 259 0 218 298 298 298 
218 298 298 298 298 298 298 298 298 219 218 219 0 0 0 0 0 0 0 258 298 298 298 298 298 219 0 0 0 0 0 218 298 259 0 0 258 298 298 298 
298 298 298 259 258 298 298 298 298 298 298 298 219 218 219 0 0 218 219 0 258 298 298 298 298 298 219 0 0 0 218 298 259 0 0 0 0 258 298 298 
298 298 259 0 0 258 298 298 298 298 298 298 298 298 298 219 218 298 259 0 218 298 298 298 259 258 259 0 0 0 258 298 219 0 0 0 0 0 258 298 
298 259 0 0 0 0 258 298 298 259 258 298 298 298 298 298 298 259 0 218 298 298 298 298 219 0 0 218 219 0 0 258 298 219 0 0 0 0 0 258 
259 0 0 0 0 0 218 298 259 0 0 258 298 298 298 298 259 0 218 298 298 298 298 298 298 219 218 298 298 219 0 0 258 298 219 0 0 0 0 0 
0 0 0 0 0 218 298 259 0 0 0 0 258 298 298 298 219 218 298 298 298 298 298 298 298 298 298 298 298 259 0 0 0 258 259 0 0 0 0 0 
0 0 0 0 0 258 259 0 0 0 0 0 0 258 298 298 298 298 298 298 298 298 298 298 298 298 298 298 259 0 0 0 0 0 0 0 0 0 0 0 
0 218 219 0 0 0 0 218 219 0 0 0 0 0 258 298 298 298 298 259 258 298 298 298 298 298 298 259 0 0 218 219 0 0 218 219 0 0 0 218 
218 298 298 219 0 0 218 298 259 0 0 0 0 0 0 258 298 298 259 0 0 258 298 298 298 298 259 0 0 218 298 298 219 218 298 259 0 0 218 298 
298 298 298 298 219 218 298 259 0 0 0 0 0 0 0 0 258 259 0 0 0 0 258 298 298 259 0 0 218 298 298 298 298 298 259 0 0 218 298 298 
298 298 298 298 298 298 298 219 0 0 0 0 0 0 0 0 0 0 0 0 0 0 218 298 298 219 0 0 258 298 298 298 298 259 0 0 218 298 298 298 
298 298 298 298 298 298 298 259 0 218 219 0 0 0 0 0 0 0 0 0 0 218 298 298 298 298 219 0 0 258 298 298 259 0 0 218 298 298 298 298 
298 298 298 298 298 298 298 219 218 298 259 0 0 0 0 0 0 0 0 0 218 298 298 298 298 298 298 219 0 0 258 298 219 0 0 258 298 298 298 298 
298 298 298 298 298 298 298 298 298 259 0 0 0 0 0 0 0 0 0 218 298 298 298 298 298 298 298 259 0 0 218 298 298 219 0 0 258 298 298 298 
298 298 298 298 298 298 298 298 259 0 0 0 0 0 0 0 0 0 218 298 298 298 298 298 298 298 259 0 0 218 298 298 298 259 0 0 218 298 298 298 
258 298 298 298 298 298 298 259 0 0 0 0 0 218 219 0 0 218 298 298 298 298 298 298 298 259 0 0 218 298 298 298 259 0 0 218 298 298 298 298 
0 258 298 298 298 298 298 219 0 0 218 219 218 298 298 219 218 298 298 298 298 298 298 298 259 0 0 218 298 298 298 259 0 0 218 298 298 298 298 298 
0 0 258 298 298 298 298 298 219 218 298 298 298 298 298 298 298 298 298 298 298 298 298 298 219 0 0 258 298 298 259 0 0 218 298 298 298 298 298 298 
0 0 0 258 298 298 298 298 298 298 298 298 298 298 298 298 298 298 298 298 298 298 298 298 298 219 0 0 258 259 0 0 218 298 298 298 298 298 298 298 
0 0 0 218 298 298 298 298 298 298 298 298 298 298 298 298 298 298 298 298 298 298 298 298 298 298 219 0 0 0 0 0 258 298 298 298 298 298 298 298 
0 0 218 298 298 298 298 298 298 298 298 298 298 298 298 298 298 298 298 298 298 298 298 298 259 258 298 219 0 0 0 0 0 258 298 298 298 298 298 298 
0 218 298 298 298 298 298 298 298 298 298 298 298 298 298 259 258 298 298 298 298 298 298 259 0 0 258 298 219 0 0 0 0 218 298 259 258 298 298 298 
218 298 298 298 298 298 298 298 298 298 298 298 259 258 259 0 0 258 298 298 298 298 259 0 0 0 0 258 298 219 0 0 218 298 259 0 0 258 298 298 
298 298 298 298 298 298 298 298 298 298 298 298 219 0 0 218 219 0 258 298 298 259 0 0 0 0 0 0 258 298 219 218 298 259 0 0 0 0 258 298 
298 298 298 298 298 298 298 298 298 298 298 298 298 219 218 298 298 219 0 258 298 219 0 0 0 0 0 0 218 298 298 298 259 0 0 0 0 0 0 258 
258 298 298 298 298 259 258 298 298 259 258 298 298 298 298 298 298 298 219 0 258 298 219 0 0 0 0 218 298 298 298 259 0 0 0 0 0 0 0 0 
0 258 298 298 259 0 0 258 259 0 0 258 298 298 298 298 298 298 259 0 0 258 259 0 0 0 218 298 298 298 259 0 0 0 0 0 0 0 0 0 
0 0 258 259 0 0 0 0 0 0 0 0 258 298 298 298 298 259 0 0 0 0 0 0 0 218 298 298 298 298 219 0 0 0 0 0 0 0 0 0 
0 0 0 0 0 0 0 0 0 0 0 0 218 298 298 298 259 0 0 0 0 0 0 0 218 298 259 258 298 298 298 219 0 0 0 0 0 0 0 0 
0 0 0 0 0 0 0 0 0 0 0 218 298 298 298 298 219 0 0 0 0 0 0 218 298 259 0 0 258 298 298 298 219 0 0 0 0 0 0 0 
0 0 0 0 0 0 0 0 0 0 218 298 298 298 259 258 298 219 0 0 0 0 0 258 259 0 0 0 0 258 298 298 298 219 0 0 0 0 0 0 
0 0 0 0 0 0 0 0 0 218 298 298 298 259 0 0 258 298 219 0 0 0 0 0 0 0 0 0 0 0 258 298 298 298 219 0 0 0 0 0 
0 0 0 0 0 0 0 0 218 298 298 298 259 0 0 0 0 258 298 219 0 0 0 0 0 0 0 0 0 0 218 298 298 298 259 0 0 0 0 0 
0 0 0 0 0 0 0 218 298 298 298 259 0 0 0 0 0 0 258 298 219 0 0 0 0 0 0 0 0 218 298 298 298 259 0 0 0 0 0 0 
0 0 0 0 0 0 218 298 298 298 259 0 0 0 0 0 0 0 0 258 298 219 0 0 0 0 0 0 218 298 298 298 259 0 0 0 0 0 0 0 
0 0 0 0 0 218 298 298 298 259 0 0 0 0 0 0 0 0 0 218 298 298 219 0 0 0 0 218 298 298 298 259 0 0 0 0 0 0 0 0 
0 0 0 0 218 298 298 298 259 0 0 0 0 0 0 0 0 0 218 298 298 298 298 219 0 0 218 298 298 298 259 0 0 0 0 0 0 0 0 0 
0 0 0 218 298 298 298 259 0 0 0 0 0 0 0 0 0 218 298 298 298 298 298 298 219 218 298 298 298 259 0 0 0 0 0 0 0 0 0 0 
0 0 218 298 298 298 298 219 0 0 0 0 0 0 0 0 218 298 298 298 298 298 298 298 298 298 298 298 259 0 0 0 0 0 0 0 0 0 0 0 
0 218 298 298 298 259 258 298 219 0 0 0 0 0 0 218 298 298 298 298 298 298 298 298 298 298 298 259 0 0 0 0 0 0 0 0 0 0 0 0 
218 298 298 298 259 0 0 258 298 219 0 0 0 0 218 298 298 298 259 258 259 258 259 258 298 298 298 219 0 0 0 0 0 0 0 0 0 0 0 0 
298 298 298 259 0 0 0 218 298 259 0 0 0 218 298 298 298 259 0 0 0 0 0 0 258 298 298 298 219 0 0 0 0 0 0 0 0 0 0 0 
298 298 259 0 0 0 218 298 259 0 0 0 218 298 298 298 298 219 0 0 0 0 0 0 0 258 298 298 298 219 0 0 0 0 0 0 0 0 0 0 
298 259 0 0 0 0 258 298 219 0 0 218 298 298 298 298 298 259 0 0 0 0 0 0 0 218 298 298 298 298 219 0 0 0 0 0 0 0 0 0 
259 0 0 0 0 0 0 258 298 219 218 298 298 298 298 298 298 219 0 0 0 0 0 0 218 298 259 258 298 298 298 219 0 0 0 0 0 0 0 0 
0 0 0 0 0 0 0 0 258 298 298 298 298 298 298 298 298 298 219 218 219 0 0 0 258 259 0 0 258 298 298 298 219 0 0 0 0 0 0 0 
0 0 0 0 0 0 0 0 218 298 298 298 298 298 298 298 298 298 298 298 259 0 0 0 0 0 0 0 218 298 298 298 298 219 0 0 0 0 0 0 
0 0 0 0 0 0 0 218 298 259 258 298 298 298 298 298 298 298 298 259 0 0 0 0 0 0 0 218 298 298 298 298 298 298 219 0 0 0 0 0 
0 0 0 0 0 0 218 298 298 219 0 258 298 298 298 298 298 298 259 0 0 0 0 0 0 0 218 298 298 298 298 298 298 298 259 0 0 0 0 0 
0 0 0 0 0 0 258 298 298 298 219 0 258 298 298 298 298 259 0 0 0 218 219 0 0 218 298 298 298 298 298 298 298 259 0 218 219 0 0 0 
0 0 0 0 0 0 0 258 298 298 259 0 218 298 298 298 298 219 0 0 218 298 259 0 218 298 298 298 298 298 298 298 259 0 218 298 298 219 0 0 
0 0 0 0 0 0 0 218 298 259 0 218 298 298 298 298 298 298 219 0 258 298 219 218 298 298 298 298 298 298 298 259 0 218 298 298 298 298 219 0 
0 0 0 0 0 0 218 298 259 0 218 298 298 298 298 298 298 298 298 219 0 258 298 298 298 298 298 298 298 298 259 0 218 298 298 298 298 298 298 219 
0 0 0 0 0 0 258 259 0 0 258 298 298 298 298 259 258 298 298 298 219 0 258 298 298 298 298 298 298 298 219 0 258 298 298 298 298 298 298 298 
0 0 218 219 0 0 0 0 0 0 0 258 298 298 259 0 218 298 298 298 259 0 0 258 298 298 298 298 298 298 298 219 0 258 298 298 298 298 298 298 
0 218 298 298 219 0 0 0 0 0 0 0 258 259 0 218 298 298 298 298 219 0 0 0 258 298 298 298 298 298 298 298 219 0 258 298 298 298 298 259 
0 258 298 298 298 219 0 0 0 0 0 0 0 0 218 298 298 298 298 298 298 219 0 0 0 258 298 298 298 298 298 298 298 219 218 298 298 298 259 0 
0 0 258 298 298 298 219 0 0 0 0 0 0 0 258 298 298 298 298 298 298 259 0 218 219 0 258 298 298 298 298 298 298 298 298 298 298 259 0 0 
0 0 0 258 298 298 298 219 0 0 0 0 0 0 0 258 298 298 298 298 259 0 218 298 259 0 218 298 298 298 298 298 298 298 298 298 259 0 0 0 
0 0 0 218 298 298 298 259 0 0 0 0 0 0 0 218 298 298 298 298 219 218 298 259 0 218 298 259 258 298 298 298 298 298 298 298 219 0 0 0 
0 0 218 298 298 298 259 0 218 219 0 0 0 0 218 298 298 298 298 298 298 298 259 0 0 258 259 0 218 298 298 298 298 298 298 298 298 219 0 0 
0 218 298 298 298 259 0 0 258 298 219 0 0 218 298 298 298 298 298 298 298 259 0 218 219 0 0 0 258 298 298 298 298 298 298 298 298 298 219 0 
218 298 298 298 259 0 218 219 0 258 298 219 0 258 298 298 298 298 298 298 259 0 218 298 298 219 218 219 0 258 298 298 298 298 259 258 298 298 298 219 
298 298 298 259 0 218 298 298 219 0 258 298 219 0 258 298 298 298 298 259 0 218 298 298 298 298 298 298 219 218 298 298 298 259 0 0 258 298 298 298 
298 298 298 219 218 298 298 298 298 219 218 298 298 219 0 258 298 298 298 219 0 258 298 298 298 298 298 298 298 298 298 298 298 219 0 0 0 258 298 298 
298 298 298 298 298 298 259 258 298 298 298 298 298 298 219 0 258 298 298 298 219 0 258 298 298 298 298 298 298 298 298 298 298 298 219 0 0 218 298 298 
258 298 298 298 298 298 219 0 258 298 298 298 298 298 298 219 0 258 298 298 298 219 0 258 298 298 298 298 298 259 258 298 298 298 259 0 218 298 298 298 
0 258 298 298 298 298 298 219 0 258 298 298 298 298 298 298 219 0 258 298 298 259 0 218 298 298 298 298 298 219 0 258 298 298 219 218 298 298 298 298 
0 0 258 298 298 298 298 298 219 0 258 298 298 298 298 298 298 219 0 258 259 0 218 298 298 298 298 298 298 298 219 0 258 298 298 298 298 298 298 259 
0 0 0 258 298 298 298 298 298 219 0 258 298 298 298 298 298 298 219 0 0 218 298 298 298 298 298 298 298 298 259 0 218 298 298 298 298 298 259 0 
0 0 0 0 258 298 298 298 298 259 0 0 258 298 298 298 298 298 298 219 218 298 298 298 298 298 298 298 298 259 0 218 298 298 298 298 298 259 0 0 
219 0 0 0 0 258 298 298 259 0 218 219 218 298 298 298 298 298 298 298 298 298 298 298 298 298 298 298 259 0 218 298 298 298 298 298 259 0 0 0 
298 219 0 0 0 0 258 259 0 218 298 298 298 259 258 298 298 298 298 298 298 298 298 259 258 298 298 259 0 218 298 298 298 298 298 259 0 0 0 0 
298 298 219 0 0 0 0 0 218 298 298 298 259 0 218 298 298 298 298 298 298 298 298 219 0 258 259 0 218 298 298 298 298 298 259 0 0 0 0 0 
298 298 298 219 0 0 0 218 298 298 298 259 0 218 298 259 258 259 258 298 298 298 298 298 219 0 0 0 258 298 298 298 298 259 0 0 0 0 0 0 
298 298 298 259 0 0 218 298 298 298 259 0 218 298 259 0 0 0 0 258 298 298 298 298 298 219 0 0 0 258 298 298 259 0 0 0 0 0 0 218 
298 298 259 0 0 218 298 298 298 298 219 0 258 259 0 0 0 0 0 218 298 298 298 298 298 298 219 0 0 0 258 259 0 0 0 0 0 0 218 298 
298 259 0 0 218 298 298 298 298 298 298 219 0 0 0 0 0 0 218 298 259 258 298 298 298 298 259 0 0 0 0 0 0 0 0 0 0 218 298 298 
298 219 0 0 258 298 298 298 298 298 298 298 219 0 0 0 0 218 298 259 0 0 258 298 298 259 0 0 218 219 0 0 0 0 0 0 218 298 298 298 
298 298 219 0 0 258 298 298 298 298 298 298 298 219 0 0 218 298 259 0 0 0 0 258 259 0 0 218 298 298 219 0 0 0 0 218 298 298 298 298 
298 298 298 219 0 0 258 298 298 298 298 259 258 298 219 218 298 259 0 0 0 0 0 0 0 0 218 298 298 298 298 219 0 0 218 298 298 298 298 298 
298 298 298 298 219 0 0 258 298 298 259 0 0 258 298 298 259 0 0 0 0 0 0 0 0 218 298 298 298 298 298 298 219 218 298 298 298 259 258 298 
298 298 298 298 259 0 0 0 258 259 0 0 0 0 258 259 0 0 0 0 0 0 0 0 218 298 259 258 298 298 298 298 298 298 298 298 259 0 0 258 
298 298 298 259 0 0 0 0 0 0 0 0 0 0 0 0 0 0 0 0 0 0 0 218 298 259 0 0 258 298 298 259 258 298 298 259 0 0 0 0 
298 298 259 0 0 0 0 0 0 0 0 0 0 0 0 0 0 0 0 0 0 0 218 298 259 0 0 0 0 258 259 0 0 258 259 0 0 0 0 0 
0
