12 12 21 10 0 0 0 0 0 0 0 0 0 0 0 0 11 20 21 10 0 20 21 28 28 20 21 28 28 20 12 12 12 12 12 12 12 12 12 12 
12 12 21 10 0 0 0 0 0 0 0 0 0 0 0 0 11 20 21 10 0 20 21 28 28 20 21 28 28 20 12 12 12 12 12 12 12 12 12 12 
12 12 21 10 0 0 0 0 0 0 0 0 0 0 0 0 11 20 21 10 0 20 21 28 28 20 21 28 28 20 12 12 12 12 12 12 12 12 12 12 
12 12 21 10 0 0 0 0 0 0 0 0 0 0 0 0 11 20 21 10 0 20 21 28 28 20 21 28 28 20 13 23 23 23 23 23 23 23 23 23 
12 12 21 10 0 0 0 0 0 0 0 0 0 0 0 0 11 20 21 10 0 20 21 28 28 20 21 28 28 22 24 28 28 0 0 0 0 0 0 0 
12 12 21 10 0 0 0 0 0 0 0 0 0 0 0 0 11 20 21 10 0 20 21 28 28 20 21 28 28 28 28 28 28 0 0 0 0 0 0 0 
12 12 21 10 0 0 0 0 0 0 0 0 0 0 0 0 11 20 21 10 0 20 21 28 28 22 24 28 28 28 28 28 28 0 0 0 0 0 0 0 
12 12 21 10 0 0 0 0 0 0 0 0 0 0 0 0 11 20 21 10 0 20 21 28 28 28 28 28 28 28 28 28 28 0 0 0 0 0 0 0 
12 12 21 10 0 0 0 0 0 0 0 0 0 0 0 0 11 20 21 10 0 22 24 28 28 28 28 28 28 28 28 28 28 0 17 18 18 18 18 18 
12 12 21 10 0 0 0 0 0 0 0 0 0 0 0 0 11 20 21 10 0 28 28 28 28 28 28 28 28 28 28 0 0 0 20 12 12 12 12 12 
12 12 21 10 0 0 0 0 0 0 0 0 0 0 0 0 11 20 21 10 0 28 28 28 28 28 28 28 28 28 28 0 0 0 20 12 12 12 12 12 
12 12 21 10 0 0 0 0 0 0 0 0 0 0 0 0 11 20 21 10 0 28 28 28 28 28 28 28 28 0 0 0 0 0 20 12 12 12 12 12 
23 23 24 0 0 0 0 0 0 0 0 0 0 0 0 0 11 22 24 10 0 28 28 28 28 28 28 28 28 0 0 0 0 0 20 12 12 12 12 12 
0 0 0 0 0 0 0 0 0 0 0 0 0 0 0 0 0 9 9 0 0 28 28 28 28 28 28 28 28 0 0 0 0 0 20 12 12 12 12 12 
0 0 0 0 0 0 0 0 0 0 0 0 0 0 0 0 0 0 0 0 0 28 28 28 28 28 28 28 28 0 0 0 0 0 20 12 12 12 12 12 
0 0 0 0 0 0 0 0 0 0 0 0 0 0 0 0 0 0 0 0 0 0 0 28 28 28 28 0 0 0 0 0 0 0 20 12 12 12 12 12 
0 0 0 0 0 0 0 0 0 0 0 0 0 0 0 0 0 0 0 0 0 0 0 28 28 28 28 0 0 0 0 0 0 0 20 12 12 12 12 12 
0 0 0 0 0 0 0 0 0 0 0 0 0 0 0 0 0 0 0 0 0 0 0 0 0 0 0 0 0 0 0 0 0 0 20 12 12 12 12 12 
18 18 18 18 18 18 18 19 0 0 0 0 0 0 0 0 0 0 0 0 0 0 0 0 0 0 0 0 0 0 0 0 0 0 20 12 12 12 12 12 
12 12 12 12 12 12 12 21 10 0 0 0 0 0 0 0 0 0 0 0 0 0 0 0 0 0 0 0 0 0 0 0 0 0 20 12 12 12 12 12 
23 23 23 23 23 23 23 24 0 0 0 0 0 0 0 0 0 0 0 0 0 0 0 0 0 0 0 0 0 0 0 0 0 0 20 12 12 12 12 12 
0 0 0 0 0 0 0 0 0 0 0 0 0 0 0 0 0 0 0 0 0 0 0 0 0 0 0 0 0 0 0 0 0 0 20 12 12 12 12 12 
0 0 0 0 0 0 0 0 0 0 0 0 0 0 0 0 0 0 0 0 0 0 0 0 0 0 0 0 0 0 0 0 0 0 20 12 12 12 12 12 
0 0 0 0 0 0 0 0 0 0 0 0 0 0 0 0 0 0 0 0 0 0 0 0 0 0 0 0 0 0 0 0 0 0 20 12 12 12 12 12 
0 0 0 0 0 0 0 0 0 0 0 0 0 0 0 0 0 0 0 0 0 0 0 0 0 0 0 0 0 0 0 0 0 0 20 12 12 12 12 12 
0 0 0 0 0 0 0 0 0 0 0 0 0 0 0 0 0 0 0 0 0 0 0 0 0 17 18 19 0 0 0 0 0 0 20 12 12 12 12 12 
18 18 18 18 18 19 10 0 0 0 0 0 0 0 0 0 0 0 0 0 0 0 0 0 0 20 12 21 0 0 0 0 0 0 20 12 12 12 12 12 
12 12 12 12 12 21 10 0 0 0 0 0 0 0 0 0 0 0 0 0 0 0 0 0 0 20 12 21 0 0 0 0 0 0 20 12 12 12 12 12 
12 12 12 12 12 21 10 0 0 0 0 0 0 0 0 0 0 0 0 0 0 0 0 0 0 20 12 21 0 0 0 0 0 0 20 12 12 12 12 12 
12 12 12 12 12 15 18 18 18 18 18 18 18 18 18 18 18 18 18 18 18 18 18 18 18 16 12 21 0 0 0 0 0 0 20 12 12 12 12 12 
12 12 12 12 12 12 12 12 12 12 12 12 12 12 12 12 12 12 12 12 12 12 12 12 12 12 12 21 0 0 0 0 0 0 20 12 12 12 12 12 
12 12 12 12 12 12 13 23 23 23 23 23 23 14 13 23 23 23 23 23 23 23 14 12 12 12 12 21 0 0 0 0 0 0 20 12 12 12 12 12 
12 12 12 12 12 12 21 9 9 9 9 9 9 22 24 9 9 9 9 9 9 9 22 23 23 23 23 24 0 0 0 0 0 0 20 12 12 12 12 12 
12 12 12 12 12 12 21 0 0 0 0 0 0 0 0 0 0 0 0 0 0 0 0 0 0 0 0 0 0 0 0 0 0 0 20 12 12 12 12 12 
12 12 12 12 12 12 21 0 0 0 0 0 0 0 0 0 0 0 0 0 0 0 0 0 0 0 0 0 28 28 0 0 0 0 20 12 12 12 12 12 
12 12 12 12 12 12 21 0 0 0 0 0 0 0 0 0 0 0 0 0 0 0 0 0 0 0 0 0 28 28 0 0 0 0 20 12 12 12 12 12 
12 12 12 12 12 12 21 0 0 0 0 0 0 0 0 0 0 0 0 0 0 0 0 0 0 0 28 28 28 28 0 0 0 0 20 12 12 12 12 12 
12 12 12 12 12 12 21 0 0 0 0 0 0 0 0 0 0 0 0 0 0 0 0 0 0 0 28 28 28 28 0 0 0 0 20 12 12 12 12 12 
12 12 12 12 12 12 21 0 0 0 0 0 0 0 0 0 0 0 0 0 0 0 28 28 28 28 28 28 28 28 0 0 0 0 20 12 12 12 12 12 
12 12 12 12 12 12 21 0 0 0 0 0 0 0 0 0 0 0 0 0 0 0 28 28 28 28 28 28 28 28 0 0 0 0 20 12 12 12 12 12 
12 12 12 12 12 12 21 0 0 0 0 0 0 8 8 0 0 0 0 0 0 0 28 28 28 28 28 6 28 28 0 0 0 0 20 12 12 12 12 12 
12 12 12 12 12 12 21 0 0 0 0 0 0 25 27 0 0 0 0 0 0 0 28 28 28 28 28 26 28 28 0 0 0 0 20 12 12 12 12 12 
12 12 12 12 12 12 21 0 0 0 0 0 0 9 9 0 0 0 0 0 0 0 28 28 28 28 28 7 28 28 0 0 0 0 20 12 12 12 12 12 
12 12 12 12 12 12 21 0 0 0 0 0 0 0 0 0 0 0 0 0 0 0 28 28 28 28 28 28 28 28 0 0 0 0 20 12 12 12 12 12 
12 12 12 12 12 12 21 0 0 0 0 0 0 0 0 0 0 0 0 0 0 0 28 28 28 28 28 28 28 28 0 0 0 0 20 12 12 12 12 12 
12 12 12 12 12 12 21 0 0 0 0 0 0 0 0 0 0 0 0 0 0 0 28 28 28 28 28 28 28 28 0 0 0 0 20 12 12 12 12 12 
12 12 12 12 12 12 21 0 0 0 0 0 0 0 0 0 0 0 0 0 0 0 28 28 28 28 28 28 28 28 0 0 0 0 20 12 12 12 12 12 
12 12 12 12 12 12 21 0 0 0 0 0 0 0 0 0 0 0 0 0 0 0 28 28 28 28 28 28 28 28 0 0 0 0 20 12 12 12 12 12 
12 12 12 12 12 12 21 0 0 0 0 0 0 0 0 0 0 0 0 0 0 28 28 28 28 28 28 28 28 28 0 0 0 0 20 12 12 12 12 12 
12 12 12 12 12 12 21 0 0 0 0 0 0 0 0 0 0 0 0 0 0 28 28 28 28 28 28 28 28 28 0 0 0 0 20 12 12 12 12 12 
12 12 12 12 12 12 21 8 8 8 8 8 8 17 18 18 18 19 8 8 8 6 17 18 18 18 18 19 28 28 0 0 0 0 20 12 12 12 12 12 
12 12 12 12 12 12 15 18 18 18 18 18 18 16 12 12 12 15 18 18 18 18 16 12 12 12 12 21 28 28 0 0 0 0 20 12 12 12 12 12 
12 12 12 12 12 12 12 12 12 12 12 12 12 12 12 12 12 12 12 12 12 12 12 12 12 12 12 21 6 6 0 0 0 0 20 12 12 12 12 12 
12 12 12 12 12 12 12 12 12 12 12 12 12 12 12 12 12 12 12 12 12 12 12 12 12 12 12 15 18 19 0 0 0 0 20 12 12 12 12 12 
12 12 12 12 12 13 23 23 23 23 23 23 23 23 23 23 23 23 23 23 23 23 23 23 14 13 23 23 23 24 0 0 0 0 20 12 12 12 12 12 
12 12 12 12 12 21 10 0 0 0 0 0 0 0 0 0 0 0 0 0 28 28 28 28 20 21 28 28 28 28 0 0 0 0 20 12 12 12 12 12 
12 12 12 12 12 21 10 0 0 0 0 0 0 0 0 0 0 0 0 0 28 28 28 28 20 21 28 28 28 28 0 0 0 0 20 12 12 12 12 12 
12 12 12 12 12 21 10 0 0 0 0 0 0 0 0 0 0 0 0 0 28 28 28 28 22 24 28 28 28 28 0 0 0 0 20 12 12 12 12 12 
12 12 12 12 12 21 10 0 0 0 0 0 0 0 0 0 0 0 0 0 28 28 28 28 28 28 28 28 28 28 0 0 0 0 20 12 12 12 12 12 
12 12 12 12 12 21 10 0 0 0 0 0 0 0 0 0 0 0 0 0 28 28 28 28 28 28 28 28 28 0 0 0 0 0 20 12 12 12 12 12 
12 12 12 12 12 21 10 0 0 0 0 0 0 0 0 0 0 0 0 0 28 28 28 28 28 28 28 28 28 0 0 0 0 0 20 12 12 12 12 12 
12 12 12 12 12 21 10 0 0 0 0 0 0 0 0 0 0 0 28 28 28 28 28 28 28 28 28 28 28 0 0 0 0 0 20 12 12 12 12 12 
12 12 12 12 12 21 10 0 0 0 0 0 0 0 0 0 0 0 28 28 28 28 28 28 28 28 28 28 28 0 0 0 0 0 20 12 12 12 12 12 
12 12 12 12 12 21 10 0 0 0 0 25 27 0 0 0 28 28 28 28 28 28 28 28 28 28 28 0 0 0 0 0 0 0 20 12 12 12 12 12 
12 12 12 12 12 21 10 0 0 0 0 0 0 0 0 0 28 28 28 28 28 28 28 28 28 28 28 0 0 0 0 0 0 0 20 12 12 12 12 12 
12 12 12 12 12 21 10 0 0 0 0 0 0 0 0 0 28 28 28 28 28 28 28 28 28 28 28 0 0 0 0 0 0 0 20 12 12 12 12 12 
12 12 12 12 12 21 10 0 0 0 0 0 0 0 0 0 28 28 28 28 28 0 0 0 0 0 0 0 0 0 0 0 0 0 20 12 12 12 12 12 
12 12 12 12 12 21 10 0 0 0 0 0 0 0 28 28 28 28 28 28 28 0 0 0 0 0 0 0 0 0 0 0 0 0 20 12 12 12 12 12 
12 12 12 12 12 21 10 0 0 0 0 0 0 0 28 28 28 28 28 28 28 0 0 0 0 0 0 0 0 0 0 0 0 0 20 12 12 12 12 12 
12 12 12 12 12 21 10 0 0 0 0 0 0 0 28 28 28 28 28 28 28 0 0 0 17 19 0 0 0 0 0 0 0 0 20 12 12 12 12 12 
12 12 12 12 12 21 10 0 0 0 0 0 0 0 28 28 28 28 28 28 28 0 0 0 20 21 0 0 0 0 0 0 0 0 20 12 12 12 12 12 
12 12 12 12 12 21 10 0 0 0 0 0 0 0 28 28 28 28 28 28 28 0 0 0 20 21 0 0 0 0 0 0 0 0 20 12 12 12 12 12 
12 12 12 12 12 15 18 18 18 18 18 18 18 18 18 18 18 18 18 18 18 18 18 18 16 21 0 0 0 0 0 0 0 0 20 12 12 12 12 12 
12 12 12 12 12 12 12 12 12 12 12 12 12 12 12 12 12 12 12 13 23 23 23 23 23 24 0 0 0 0 0 0 0 0 20 12 12 12 12 12 
12 12 12 12 12 12 12 12 12 12 12 12 12 12 12 12 12 12 13 24 28 0 0 28 0 0 0 0 0 0 0 0 0 0 20 12 12 12 12 12 
12 12 12 12 12 12 12 12 12 12 12 12 12 12 12 12 12 13 24 28 28 0 0 0 0 0 0 0 0 0 0 0 0 0 20 12 12 12 12 12 
12 12 12 12 12 12 12 12 12 12 12 12 12 12 12 12 13 24 28 28 28 28 28 0 0 0 0 0 0 0 0 0 0 0 20 12 12 12 12 12 
12 12 12 12 12 12 12 12 12 12 12 12 12 12 12 13 24 28 28 28 28 28 28 0 0 0 0 0 0 0 0 0 0 0 20 12 12 12 12 12 
12 12 12 12 12 12 12 12 12 12 12 12 12 12 13 24 28 28 28 28 28 28 28 28 28 0 0 0 0 0 0 0 0 0 20 12 12 12 12 12 
12 12 12 12 12 12 12 12 12 12 12 12 12 13 24 28 28 28 28 28 28 28 28 28 28 0 0 0 0 0 0 0 0 0 20 12 12 12 12 12 
12 12 12 12 12 12 12 12 12 12 12 12 13 24 28 28 28 28 28 28 28 17 19 28 28 28 28 0 0 0 0 0 0 0 20 12 12 12 12 12 
12 12 12 12 12 12 12 12 12 12 12 13 24 0 28 28 28 28 28 28 28 20 21 28 28 28 28 0 0 0 0 0 0 0 20 12 12 12 12 12 
12 12 12 12 12 12 12 12 12 12 13 24 0 0 28 28 28 28 28 28 17 16 21 28 28 28 28 0 0 0 0 0 0 0 20 12 12 12 12 12 
12 12 12 12 12 12 12 12 12 13 24 0 0 0 28 28 28 28 28 28 20 12 21 28 28 28 28 0 0 0 0 0 0 0 20 12 12 12 12 12 
12 12 12 12 12 12 12 12 13 24 0 0 0 0 28 28 28 28 28 17 16 12 21 28 28 28 28 0 0 0 0 0 0 0 20 12 12 12 12 12 
12 12 12 12 12 12 12 13 24 0 0 0 0 0 28 28 28 28 28 20 12 12 21 28 28 28 28 0 0 0 0 0 0 0 20 12 12 12 12 12 
12 12 12 12 12 12 13 24 0 0 0 0 0 0 28 28 28 28 17 16 12 12 21 28 28 28 28 0 0 0 0 0 0 0 20 12 12 12 12 12 
12 12 12 12 12 13 24 0 0 0 0 0 28 28 28 28 28 28 20 12 12 12 21 28 28 28 28 0 0 0 0 0 0 0 20 12 12 12 12 12 
12 12 12 12 13 24 0 0 0 0 0 0 28 28 28 28 28 17 16 12 12 12 21 28 28 28 28 0 0 0 0 0 0 0 20 12 12 12 12 12 
12 12 12 13 24 0 0 0 0 0 0 0 28 28 28 28 28 20 12 12 12 12 21 28 28 28 28 0 0 0 0 0 0 0 20 12 12 12 12 12 
12 12 13 24 0 0 0 0 0 0 0 0 28 28 28 28 17 16 12 12 12 12 21 28 28 28 28 0 0 0 0 0 0 0 20 12 12 12 12 12 
23 23 24 0 0 0 0 0 0 0 0 0 28 28 28 28 20 12 12 12 12 12 21 28 28 28 28 0 0 0 0 0 0 0 20 12 12 12 12 12 
0 0 0 0 0 0 0 0 0 0 0 0 28 28 28 17 16 12 12 12 12 12 21 28 28 28 28 0 0 0 0 0 0 0 20 12 12 12 12 12 
0 0 0 0 0 0 0 0 0 0 0 0 28 28 28 20 12 12 12 12 12 12 21 28 28 28 28 0 0 0 0 0 0 0 20 12 12 12 12 12 
0 0 0 0 0 0 0 0 0 0 0 0 28 28 17 16 12 12 12 12 12 12 21 28 28 28 28 0 0 0 0 0 0 0 20 12 12 12 12 12 
0 0 0 0 0 0 0 0 0 0 0 0 28 28 20 12 12 12 12 12 12 12 21 28 28 0 0 0 0 0 0 0 0 0 20 12 12 12 12 12 
18 18 18 18 18 18 18 18 18 18 18 18 18 18 16 12 12 12 12 12 12 12 21 28 28 0 0 0 0 0 0 0 0 0 20 12 12 12 12 12 
12 12 12 12 12 12 12 12 12 12 12 12 12 12 12 12 12 12 12 12 12 12 21 28 28 0 0 0 0 0 0 0 0 0 20 12 12 12 12 12 
12 12 12 12 12 12 12 12 12 12 12 12 12 12 12 12 12 12 12 12 12 12 21 28 28 0 0 0 0 0 0 0 0 0 20 12 12 12 12 12 
12 12 12 12 12 12 12 12 12 12 12 12 12 12 12 12 12 12 12 12 12 12 21 28 28 0 0 0 0 0 0 0 0 0 20 12 12 12 12 12 
13
7 69 11 136
23 74 10 0
23 80 11 88
7 57 11 136
27 55 10 0
13 63 11 168
27 33 12 56
15 41 11 96
27 43 12 56
28 41 11 48
7 26 11 144
4 2 11 96
9 19 11 200
