92 92 92 92 92 214 0 0 0 0 0 0 212 92 93 253 253 253 94 92 92 92 92 92 92 92 92 92 92 92 92 92 93 253 253 253 94 92 92 92 
92 92 92 92 92 214 0 0 0 0 0 0 212 92 214 0 0 0 212 92 92 92 92 92 92 92 92 92 92 92 92 92 214 0 0 0 212 92 92 92 
92 92 92 92 92 214 0 0 0 0 0 0 212 92 214 0 0 0 212 92 92 92 92 92 92 92 92 92 92 92 92 92 214 0 0 0 212 92 92 92 
92 92 92 92 92 214 0 0 0 0 0 0 212 92 214 0 0 0 212 92 92 92 92 92 92 92 92 92 92 92 92 92 214 0 0 0 212 92 92 92 
92 92 92 92 92 214 0 0 0 0 0 0 252 253 254 0 0 0 252 253 253 253 253 253 253 253 253 253 253 253 253 253 254 0 0 0 252 253 253 94 
92 92 92 92 92 214 0 0 0 0 0 0 0 0 0 0 0 0 0 0 0 0 0 0 0 0 0 0 0 0 0 0 0 0 0 0 0 0 0 212 
92 92 92 92 92 214 0 0 0 0 0 0 0 0 0 0 0 0 0 0 0 0 0 0 0 0 0 0 0 0 0 0 0 0 0 0 0 0 0 212 
92 92 92 92 92 214 0 0 0 0 0 0 0 0 0 0 0 0 0 0 0 0 0 0 0 0 0 0 0 0 0 0 0 0 0 0 0 0 0 212 
92 92 92 92 92 214 0 0 0 0 0 0 0 0 0 0 0 0 0 0 0 0 0 0 0 0 0 0 0 0 763 764 764 764 764 764 764 764 764 212 
92 92 92 92 92 214 0 0 0 0 0 0 0 0 0 0 0 0 0 0 0 0 0 0 0 0 0 0 0 0 803 683 683 683 683 683 683 683 683 212 
92 92 92 92 92 214 0 0 0 0 0 0 0 0 0 0 0 0 0 0 0 0 0 0 0 0 0 0 0 0 803 683 683 683 683 683 683 683 683 212 
92 92 92 92 92 133 173 173 173 173 173 173 173 173 173 173 173 173 173 173 173 173 173 174 0 0 0 172 173 173 173 173 174 683 683 683 683 683 683 212 
92 92 92 92 92 92 92 92 92 92 92 92 92 92 92 92 92 92 92 92 92 92 92 214 0 0 0 212 92 92 92 92 214 683 683 683 683 683 683 212 
92 92 92 92 92 92 92 92 92 92 92 92 92 92 92 92 92 92 92 92 92 92 92 133 173 173 173 134 92 92 92 92 214 683 683 683 683 683 683 212 
92 92 92 92 92 92 92 92 92 92 92 92 92 92 92 92 92 92 92 92 92 92 92 93 253 253 253 94 92 92 92 92 214 683 683 683 683 683 683 212 
92 92 92 92 92 92 92 92 92 92 92 92 92 92 92 92 92 92 92 92 92 92 92 214 0 0 0 212 92 92 92 92 214 683 683 683 683 683 683 212 
92 92 92 92 92 93 253 253 253 253 253 253 253 253 253 253 253 253 253 253 253 253 253 254 0 0 0 252 253 253 253 253 254 683 683 683 683 683 683 212 
92 92 92 92 92 214 0 0 0 0 0 0 0 0 0 0 0 0 0 0 0 0 0 0 0 0 0 0 0 0 803 683 683 683 683 683 683 683 683 212 
92 92 92 92 92 214 0 0 0 0 0 0 0 0 0 0 0 0 0 0 0 0 0 0 0 0 0 0 0 0 803 683 683 683 683 683 683 683 683 212 
92 92 92 92 92 214 0 0 0 0 0 0 0 0 0 0 0 0 0 0 0 0 0 0 0 0 0 0 0 0 803 683 683 683 683 683 683 683 683 212 
92 92 92 92 92 214 764 764 764 764 764 764 764 764 764 764 764 764 764 764 764 764 764 764 764 764 764 764 764 764 725 683 683 683 683 683 683 683 683 212 
92 92 92 92 92 214 683 683 683 683 683 683 683 683 683 683 683 683 683 683 683 683 683 683 683 683 683 683 683 683 683 683 683 683 683 683 683 683 683 212 
92 92 92 92 92 214 683 683 683 683 683 683 683 683 683 683 683 683 683 683 683 683 683 683 683 683 683 683 683 683 683 683 683 683 683 683 683 683 683 212 
92 92 92 92 92 214 683 683 683 683 683 683 683 683 683 683 683 683 683 683 683 683 683 683 683 683 683 683 683 683 683 683 683 683 683 683 683 683 683 212 
92 92 92 92 92 214 683 683 683 683 683 683 172 173 174 683 683 683 172 173 173 173 173 173 173 173 173 173 173 173 173 173 174 683 683 683 172 173 173 134 
92 92 92 92 92 214 683 683 683 683 683 683 212 92 214 683 683 683 212 92 92 92 92 92 92 92 92 92 92 92 92 92 214 683 683 683 212 92 92 92 
92 92 92 92 92 214 683 683 683 683 683 683 212 92 214 683 683 683 212 92 92 92 92 92 92 92 92 92 92 92 92 92 214 683 683 683 212 92 92 92 
92 92 92 92 92 214 683 683 683 683 683 683 212 92 214 683 683 683 212 92 92 92 92 92 92 92 92 92 92 92 92 92 214 683 683 683 212 92 92 92 
92 92 92 92 92 214 683 683 683 683 683 683 212 92 133 173 173 173 134 92 92 92 92 92 92 92 92 92 92 92 92 92 133 173 173 173 134 92 92 92 
7
15 1 1 0 3 0 0 320 240
33 1 1 0 3 0 0 320 240
15 26 1 1 3 0 0 320 240
24 22 1 1 3 0 0 320 240
8 9 10 1
8 17 10 0
24 5 1 0 3 0 0 320 240
