110 110 110 110 110 110 232 704 704 704 704 704 230 110 110 110 110 110 110 110 110 110 110 110 110 110 110 110 110 110 110 110 110 110 110 110 110 110 110 110 
110 110 110 110 111 271 272 704 704 704 704 704 230 110 110 110 110 110 110 110 110 110 110 110 110 110 110 110 110 110 110 110 110 110 110 110 110 110 110 110 
110 110 110 110 232 704 704 704 704 704 704 704 230 110 110 110 110 110 110 110 110 110 110 110 110 110 110 110 110 110 110 110 110 110 110 110 110 110 110 110 
110 110 110 110 232 704 704 704 704 704 704 704 230 110 110 110 110 110 110 110 110 110 110 110 110 110 110 110 110 110 110 110 110 110 110 110 110 110 110 110 
110 110 110 110 232 704 704 704 704 704 704 704 230 110 110 110 110 110 110 110 110 110 110 110 110 110 110 110 110 110 110 110 110 110 110 110 110 110 110 110 
110 110 110 110 232 704 704 704 704 704 704 704 230 110 110 110 110 110 110 110 110 110 110 110 110 110 110 110 110 110 110 110 110 110 110 110 110 110 110 110 
110 110 110 110 151 191 192 704 704 704 704 704 230 110 110 110 110 110 110 110 110 110 110 110 110 110 110 110 110 110 110 110 110 110 110 110 110 110 110 110 
110 110 110 110 110 110 232 704 704 704 704 704 230 110 110 110 110 110 110 110 110 110 110 110 110 110 110 110 110 110 110 110 110 110 110 110 110 110 110 110 
110 110 110 110 110 110 232 704 704 704 704 704 230 110 110 110 110 110 110 110 110 110 110 110 110 110 110 110 110 110 110 110 110 110 110 110 110 110 110 110 
110 110 110 110 110 110 232 704 704 704 704 704 230 110 110 110 110 110 110 110 110 110 110 110 110 110 110 110 110 110 110 110 110 110 110 110 110 110 110 110 
110 110 110 110 110 110 232 704 704 704 704 704 230 110 110 110 110 110 110 110 110 110 110 110 110 110 110 110 110 110 110 110 110 110 110 110 110 110 110 110 
110 110 110 110 110 110 232 704 704 704 704 704 230 110 110 110 110 110 110 110 110 110 110 110 110 110 110 110 110 110 110 110 110 110 110 110 110 110 110 110 
110 110 110 110 110 110 232 704 704 704 704 704 270 271 271 271 271 271 271 271 271 271 271 271 271 112 110 110 110 110 110 110 110 110 110 110 110 110 110 110 
110 110 110 110 110 110 232 704 704 704 704 704 704 704 704 826 0 0 0 0 0 0 0 0 0 230 110 110 110 110 110 110 110 110 110 110 110 110 110 110 
110 110 110 110 110 110 232 704 704 704 704 704 704 704 704 826 0 0 0 0 0 0 0 0 0 230 110 110 110 110 110 110 110 110 110 110 110 110 110 110 
110 110 110 110 110 110 232 704 704 704 704 704 704 704 704 826 0 0 0 0 0 0 0 0 0 230 110 110 110 110 110 110 110 110 110 110 110 110 110 110 
110 110 110 110 110 110 232 704 704 704 704 704 704 704 704 826 0 0 0 0 0 0 0 0 0 230 110 110 110 110 110 110 110 110 110 110 110 110 110 110 
110 110 110 110 110 110 232 704 704 704 704 704 704 704 704 826 0 0 0 0 0 0 0 0 0 230 110 110 110 110 110 110 110 110 110 110 110 110 110 110 
110 110 110 110 110 110 232 704 704 704 704 704 704 704 704 826 0 0 0 0 0 0 0 0 0 230 110 110 110 110 110 110 110 110 110 110 110 110 110 110 
110 110 110 110 110 110 232 704 704 704 704 704 704 704 704 826 0 0 0 0 0 0 0 0 0 230 110 110 110 110 110 110 110 110 110 110 110 110 110 110 
110 110 110 110 110 110 232 704 704 704 704 704 704 704 704 826 0 0 0 0 0 0 0 0 0 230 110 110 110 110 110 110 110 110 110 110 110 110 110 110 
110 110 110 110 110 110 232 704 704 704 704 704 704 704 704 826 0 0 0 0 0 0 0 0 0 230 110 110 110 110 110 110 110 110 110 110 110 110 110 110 
110 110 110 110 110 110 232 704 704 704 704 704 704 704 704 826 0 0 0 0 0 0 0 0 0 230 110 110 110 110 110 110 110 110 110 110 110 110 110 110 
110 110 110 110 110 110 232 704 704 704 704 704 704 704 704 826 0 0 0 0 0 0 0 0 0 230 110 110 110 110 110 110 110 110 110 110 110 110 110 110 
110 110 110 110 110 110 232 704 704 704 704 704 704 704 704 826 0 0 0 0 0 0 0 0 0 230 110 110 110 110 110 110 110 110 110 110 110 110 110 110 
110 110 110 110 110 110 151 191 191 191 191 191 191 191 191 191 191 191 191 191 192 0 0 0 0 230 110 110 110 110 110 110 110 110 110 110 110 110 110 110 
110 110 110 110 110 110 110 110 110 110 110 110 110 110 110 110 110 110 110 110 232 0 0 0 0 230 110 110 110 110 110 110 110 110 110 110 110 110 110 110 
110 110 110 110 110 110 110 110 110 110 110 110 110 110 110 110 110 110 110 110 232 0 0 0 0 230 110 110 110 110 110 110 110 110 110 110 110 110 110 110 
110 110 110 110 110 110 110 110 110 110 110 110 110 110 110 110 110 110 110 110 232 0 0 0 0 230 110 110 110 110 110 110 110 110 110 110 110 110 110 110 
1
22 13 10 0
