86 86 86 86 86 86 86 86 86 86 86 86 86 86 86 86 86 86 86 86 86 86 86 86 86 86 86 86 86 86 86 86 86 86 86 86 86 86 86 86 
86 86 86 86 86 86 86 86 86 86 86 86 86 86 86 86 86 86 86 86 86 86 86 86 86 86 86 86 86 86 86 86 86 86 86 86 86 86 86 86 
87 247 247 247 247 247 247 247 247 247 247 247 247 247 247 247 247 247 247 247 247 247 88 86 86 86 86 86 86 86 86 86 86 86 86 86 86 86 86 86 
208 698 698 698 698 698 698 698 698 698 698 698 698 698 698 698 698 698 698 698 698 698 206 86 86 86 86 86 86 86 86 86 86 86 86 86 86 86 86 86 
208 698 698 698 698 698 698 698 698 698 698 698 698 698 698 698 698 698 698 698 698 698 206 86 86 86 86 86 86 86 86 86 86 86 86 86 86 86 86 86 
208 698 698 698 698 698 698 698 698 698 698 698 698 698 698 698 698 698 698 698 698 698 206 86 86 86 86 86 86 86 86 86 86 86 86 86 86 86 86 86 
208 698 698 698 698 698 698 698 698 698 698 698 698 698 698 698 698 698 698 698 698 698 206 86 86 86 86 86 86 86 86 86 86 86 86 86 86 86 86 86 
208 698 698 698 698 698 698 698 698 698 698 698 698 698 698 698 698 698 698 698 698 698 246 247 247 247 247 247 247 247 247 247 247 247 247 247 247 88 86 86 
208 698 698 698 698 698 698 698 698 698 698 698 698 698 698 698 698 698 698 698 698 698 698 698 698 698 698 698 698 698 698 698 698 698 698 698 698 206 86 86 
208 698 698 698 698 698 698 698 698 698 698 698 698 698 698 698 698 698 698 698 698 698 698 698 698 698 698 698 698 698 698 698 698 698 698 698 698 206 86 86 
208 698 698 698 698 698 698 698 698 698 698 698 698 698 698 698 698 698 698 698 698 698 698 698 698 698 698 698 698 698 698 698 698 698 698 698 698 206 86 86 
208 698 698 698 698 698 698 698 698 698 698 698 698 698 698 698 698 698 698 698 698 698 698 698 698 698 698 698 698 698 698 698 698 698 698 698 698 206 86 86 
208 698 698 698 698 698 698 698 698 698 698 698 698 698 698 698 698 698 698 698 698 698 698 698 698 698 698 698 698 698 698 698 698 698 698 698 698 246 247 247 
208 698 698 698 698 698 698 698 698 698 698 698 698 698 698 698 698 698 698 698 698 698 698 698 698 698 698 698 698 698 698 698 698 698 698 698 698 698 698 698 
208 698 698 698 698 698 698 698 698 698 698 698 698 698 698 698 698 698 698 698 698 698 698 698 698 698 698 698 698 698 698 698 698 698 698 698 698 698 698 698 
208 698 698 698 698 698 698 698 698 698 698 698 698 698 698 698 698 698 698 698 698 698 698 698 698 698 698 698 698 698 698 698 698 698 698 698 698 698 698 698 
208 698 698 698 698 698 698 698 698 698 698 698 698 698 698 698 698 698 698 698 698 698 698 698 698 698 698 698 698 698 698 698 698 698 698 698 698 698 698 698 
208 698 698 698 698 698 698 698 698 698 698 698 698 698 698 698 698 698 698 698 698 698 698 698 698 698 698 698 698 698 698 698 698 698 698 698 698 698 698 698 
208 698 698 698 698 698 698 698 698 698 698 698 698 698 698 698 698 698 698 698 698 698 698 698 698 698 698 698 698 698 698 698 698 698 698 698 698 698 698 698 
127 167 167 167 167 167 167 167 167 167 167 167 167 167 168 698 698 698 698 698 698 698 698 698 698 698 698 698 698 698 698 698 698 698 698 698 698 698 698 698 
86 86 86 86 86 86 86 86 86 86 86 86 86 86 208 698 698 698 698 698 698 698 698 698 698 698 698 698 698 698 698 698 698 698 698 698 698 698 698 698 
86 86 86 86 86 86 86 86 86 86 86 86 86 86 127 167 167 167 167 167 167 167 167 167 167 167 168 698 698 698 698 698 698 698 698 698 698 698 698 698 
86 86 86 86 86 86 86 86 86 86 86 86 86 86 86 86 86 86 86 86 86 86 86 86 86 86 208 698 698 698 698 698 698 698 698 698 698 698 698 698 
86 86 86 86 86 86 86 86 86 86 86 86 86 86 86 86 86 86 86 86 86 86 86 86 86 86 127 167 167 167 167 167 167 167 167 167 167 167 167 167 
86 86 86 86 86 86 86 86 86 86 86 86 86 86 86 86 86 86 86 86 86 86 86 86 86 86 86 86 86 86 86 86 86 86 86 86 86 86 86 86 
86 86 86 86 86 86 86 86 86 86 86 86 86 86 86 86 86 86 86 86 86 86 86 86 86 86 86 86 86 86 86 86 86 86 86 86 86 86 86 86 
86 86 86 86 86 86 86 86 86 86 86 86 86 86 86 86 86 86 86 86 86 86 86 86 86 86 86 86 86 86 86 86 86 86 86 86 86 86 86 86 
86 86 86 86 86 86 86 86 86 86 86 86 86 86 86 86 86 86 86 86 86 86 86 86 86 86 86 86 86 86 86 86 86 86 86 86 86 86 86 86 
86 86 86 86 86 86 86 86 86 86 86 86 86 86 86 86 86 86 86 86 86 86 86 86 86 86 86 86 86 86 86 86 86 86 86 86 86 86 86 86 
0
