289 289 289 289 289 289 289 289 289 289 289 289 289 289 289 289 289 289 289 289 289 289 289 289 289 289 289 289 289 289 289 289 289 289 289 289 289 289 289 289 
289 289 289 289 289 289 289 289 289 289 289 289 289 289 289 289 289 289 289 289 289 289 289 289 289 289 289 289 289 289 289 289 289 289 289 289 289 289 289 289 
289 289 289 289 289 289 289 289 289 290 450 450 450 450 450 450 450 450 450 450 450 450 450 291 289 289 289 289 289 289 289 289 289 289 289 289 289 289 289 289 
289 289 289 289 289 289 289 289 289 411 7 7 7 7 7 7 7 7 7 7 7 7 7 409 289 289 289 289 289 289 289 289 289 289 289 289 289 289 289 289 
289 289 289 289 289 289 289 289 289 411 680 680 680 680 680 680 680 680 680 680 680 680 680 409 289 289 289 289 289 289 289 289 289 289 289 289 289 289 289 289 
450 450 450 450 450 450 450 291 289 411 680 680 680 680 680 680 680 680 680 680 680 680 680 449 450 450 450 450 450 450 450 450 450 450 450 450 450 450 450 450 
0 0 0 0 0 0 0 409 289 411 680 680 680 680 680 680 680 680 680 680 680 680 680 680 680 680 680 680 680 680 680 802 0 0 0 0 0 0 0 0 
0 0 0 0 0 0 0 409 289 411 680 680 680 680 680 680 680 680 680 680 680 680 680 680 680 680 680 680 680 680 680 802 0 0 0 0 0 0 0 0 
0 0 0 0 0 0 0 409 289 411 680 680 680 680 680 680 680 680 680 680 680 680 680 680 680 680 680 680 680 680 680 802 0 0 0 0 0 0 0 0 
0 0 0 0 0 0 0 409 289 411 680 680 680 680 680 680 680 680 680 680 680 680 680 680 680 680 680 680 680 680 680 802 0 0 0 0 0 0 0 0 
0 0 0 0 0 0 0 409 289 411 680 680 680 680 680 680 680 680 680 680 680 680 680 680 680 680 680 680 680 680 680 802 0 0 0 0 0 0 0 0 
0 0 0 0 0 0 0 409 289 411 680 680 680 680 680 680 681 841 841 841 841 841 841 682 680 680 680 680 680 680 680 802 0 0 0 0 0 0 0 0 
0 0 0 0 0 0 0 409 289 411 680 680 680 680 680 680 802 0 0 0 0 0 0 800 680 680 680 680 680 680 369 370 371 0 0 0 0 0 0 0 
0 0 0 0 0 0 0 409 289 411 680 680 680 680 680 680 802 0 0 0 0 0 0 800 680 680 680 680 680 680 409 289 411 0 0 0 0 0 0 0 
0 0 0 0 0 0 0 409 289 411 680 680 680 680 680 680 802 0 0 0 0 0 0 800 680 680 680 680 680 680 409 289 411 0 0 0 0 0 0 0 
370 370 371 0 0 0 0 409 289 411 680 680 680 680 680 680 802 0 0 0 0 0 0 800 680 680 680 680 680 680 409 289 330 370 370 370 370 370 370 370 
289 289 411 0 0 0 0 409 289 411 680 680 680 680 680 680 802 0 0 0 0 0 0 800 680 680 680 680 680 680 409 289 289 289 289 289 289 289 289 289 
289 289 411 0 0 0 0 449 450 451 680 680 680 680 680 680 721 761 761 761 761 761 761 722 680 680 680 680 680 680 409 289 289 289 289 289 289 289 289 289 
289 289 411 0 0 0 0 0 800 680 680 680 680 680 680 680 680 680 680 680 680 680 680 680 680 680 680 680 680 680 409 289 289 289 289 289 289 289 289 289 
289 289 411 0 0 0 0 0 800 680 680 680 680 680 680 680 680 680 680 680 680 680 680 680 680 680 680 680 680 680 409 289 289 289 289 289 289 289 289 289 
289 289 411 0 0 0 0 0 800 680 680 680 680 680 680 680 680 680 680 680 680 680 680 680 680 680 680 680 680 680 409 289 289 289 289 289 289 289 289 289 
289 289 411 0 0 0 0 0 800 680 680 680 680 680 680 680 680 680 680 680 680 680 680 680 680 680 680 680 680 680 409 289 289 289 289 289 289 289 289 289 
289 289 330 370 370 370 370 370 370 370 370 370 370 370 370 370 371 680 680 680 680 680 680 680 680 680 680 680 680 680 409 289 289 289 289 289 289 289 289 289 
289 289 289 289 289 289 289 289 289 289 289 289 289 289 289 289 411 680 680 680 680 680 680 680 680 680 680 680 680 680 409 289 289 289 289 289 289 289 289 289 
289 289 289 289 289 289 289 289 289 289 289 289 289 289 289 289 411 6 6 6 6 6 6 6 6 6 680 680 680 680 409 289 289 289 289 289 289 289 289 289 
289 289 289 289 289 289 289 289 289 289 289 289 289 289 289 289 330 370 370 370 370 370 370 370 370 371 680 680 680 680 409 289 289 289 289 289 289 289 289 289 
289 289 289 289 289 289 289 289 289 289 289 289 289 289 289 289 289 289 289 289 289 289 289 289 289 411 841 841 841 841 409 289 289 289 289 289 289 289 289 289 
289 289 289 289 289 289 289 289 289 289 289 289 289 289 289 289 289 289 289 289 289 289 289 289 289 411 0 0 0 0 409 289 289 289 289 289 289 289 289 289 
289 289 289 289 289 289 289 289 289 289 289 289 289 289 289 289 289 289 289 289 289 289 289 289 289 411 0 0 0 0 409 289 289 289 289 289 289 289 289 289 
2
24 6 10 0
14 20 10 1
