89 89 89 89 89 89 89 89 89 89 89 89 89 89 89 89 89 89 89 89 89 89 89 89 89 211 0 0 0 0 209 89 89 89 89 89 89 89 89 89 
89 89 89 89 89 89 89 89 89 89 89 89 89 89 89 89 89 89 89 89 89 89 89 89 89 211 0 0 0 0 209 89 89 89 89 89 89 89 89 89 
89 89 89 89 89 89 89 89 89 89 89 89 89 89 89 89 89 89 89 89 89 89 89 89 89 211 0 0 0 0 209 89 89 89 89 89 89 89 89 89 
89 89 89 89 89 89 89 89 89 89 89 89 89 89 89 89 89 89 89 89 89 89 89 89 89 211 0 0 0 0 209 89 89 89 89 89 89 89 89 89 
89 89 89 89 89 89 89 89 89 89 89 89 89 89 89 89 89 89 89 89 89 89 89 89 89 211 0 0 0 0 209 89 89 89 89 89 89 89 89 89 
89 89 89 89 89 89 89 89 89 89 89 89 89 89 89 89 89 89 89 89 89 89 89 89 89 211 0 0 0 0 209 89 89 89 89 89 89 89 89 89 
89 89 89 89 89 89 89 89 90 250 250 250 91 89 89 89 89 89 90 250 250 250 91 89 89 211 0 0 0 0 209 89 89 89 89 89 89 89 89 89 
89 89 89 89 89 89 89 89 211 0 0 0 209 89 89 89 89 89 211 0 0 0 209 89 89 211 0 0 0 0 209 89 89 89 89 89 89 89 89 89 
89 89 89 89 89 89 89 89 211 0 0 0 209 89 89 89 89 89 211 0 0 0 209 89 89 211 0 0 0 0 209 89 89 89 89 89 89 89 89 89 
89 89 89 89 89 89 89 89 211 0 0 0 209 89 89 89 89 89 211 0 0 0 209 89 89 211 0 0 0 0 209 89 89 89 89 89 89 89 89 89 
89 89 90 250 250 250 250 250 251 0 0 0 249 250 250 250 250 250 251 0 0 0 249 250 250 251 0 0 0 0 209 89 89 89 89 89 89 89 89 89 
89 89 211 0 0 0 0 0 0 0 0 0 0 0 0 0 0 0 0 0 0 0 0 0 0 0 0 0 0 0 209 89 89 89 89 89 89 89 89 89 
89 89 211 0 0 0 0 0 0 0 0 0 0 0 0 0 0 0 0 0 0 0 0 0 0 0 0 0 0 0 209 89 89 89 89 89 89 89 89 89 
89 89 211 0 0 0 0 0 0 0 0 0 0 0 0 0 0 0 0 0 0 0 0 0 0 0 0 0 0 0 209 89 89 89 89 89 89 89 89 89 
89 89 211 0 0 0 0 0 0 0 0 0 0 0 0 0 0 0 0 0 0 0 0 0 0 0 0 0 0 0 209 89 89 89 89 89 89 89 89 89 
89 89 211 0 0 0 0 0 0 0 0 0 0 0 0 0 0 0 0 0 0 0 0 0 0 0 0 0 0 0 209 89 89 89 89 89 89 89 89 89 
89 89 211 0 0 0 0 0 0 0 0 0 0 0 0 0 0 0 0 0 0 0 0 0 0 0 0 0 0 0 209 89 89 89 89 89 89 89 89 89 
89 89 211 0 0 0 0 0 0 0 0 0 0 0 0 0 0 0 0 0 0 0 0 0 0 0 0 0 0 0 209 89 89 89 89 89 89 89 89 89 
89 89 211 0 0 0 0 0 0 0 0 0 0 0 0 0 0 0 0 0 0 0 0 0 0 0 0 0 0 0 209 89 89 89 89 89 89 89 89 89 
89 89 211 0 0 0 0 0 0 0 0 0 0 0 0 0 0 0 0 0 0 0 0 0 0 0 0 0 0 0 209 89 89 89 89 89 89 89 89 89 
89 89 211 0 0 0 0 169 170 170 170 170 170 171 0 0 0 169 170 170 170 170 170 170 170 170 170 170 170 170 131 89 89 89 89 89 89 89 89 89 
89 89 211 0 0 0 0 209 89 89 89 89 89 211 0 0 0 209 89 89 89 89 89 89 89 89 89 89 89 89 89 89 89 89 89 89 89 89 89 89 
89 89 211 0 0 0 0 209 89 89 89 89 89 211 0 0 0 209 89 89 89 89 89 89 89 89 89 89 89 89 89 89 89 89 89 89 89 89 89 89 
89 89 211 0 0 0 0 209 89 89 89 89 89 211 0 0 0 209 89 89 89 89 89 89 89 89 89 89 89 89 89 89 89 89 89 89 89 89 89 89 
89 89 130 170 170 170 170 131 89 89 89 89 89 130 170 170 170 131 89 89 89 89 89 89 89 89 89 89 89 89 89 89 89 89 89 89 89 89 89 89 
89 89 89 89 89 89 89 89 89 89 89 89 89 89 89 89 89 89 89 89 89 89 89 89 89 89 89 89 89 89 89 89 89 89 89 89 89 89 89 89 
89 89 89 89 89 89 89 89 89 89 89 89 89 89 89 89 89 89 89 89 89 89 89 89 89 89 89 89 89 89 89 89 89 89 89 89 89 89 89 89 
89 89 89 89 89 89 89 89 89 89 89 89 89 89 89 89 89 89 89 89 89 89 89 89 89 89 89 89 89 89 89 89 89 89 89 89 89 89 89 89 
89 89 89 89 89 89 89 89 89 89 89 89 89 89 89 89 89 89 89 89 89 89 89 89 89 89 89 89 89 89 89 89 89 89 89 89 89 89 89 89 
5
27 18 10 1
4 21 9
9 7 1 0 5 0 0 320 240
19 7 1 0 5 0 0 320 240
14 22 1 1 5 0 0 320 240
