510 510 510 510 510 510 510 510 510 510 510 510 510 510 510 510 510 510 510 510 510 510 510 510 510 510 510 510 510 510 510 510 510 510 510 510 510 510 510 510 
671 671 671 671 671 671 671 671 671 671 512 511 671 671 671 671 671 671 671 671 671 671 671 671 671 671 512 511 671 671 671 671 671 671 671 671 671 671 671 671 
9 9 9 9 9 9 9 9 9 9 630 632 9 9 9 9 9 9 9 9 9 9 9 9 9 9 630 632 9 9 9 9 0 0 0 0 0 0 0 0 
0 0 0 0 0 0 0 0 0 0 630 632 0 0 0 0 0 0 0 0 0 0 0 0 0 0 630 632 0 0 0 0 0 0 0 0 0 0 0 0 
0 0 0 0 0 0 0 0 0 0 630 632 0 0 0 0 0 0 0 0 0 0 0 0 0 0 630 632 0 0 0 0 0 0 0 0 0 0 0 0 
0 0 0 0 0 0 0 0 0 0 670 672 0 0 0 0 0 0 0 0 0 0 0 0 0 0 670 672 0 0 0 0 0 0 0 0 0 0 0 0 
0 0 0 0 0 0 0 0 0 0 9 9 0 0 0 0 0 0 0 0 0 0 0 0 0 0 9 9 0 0 0 0 0 0 0 0 0 0 0 0 
0 0 0 0 0 0 0 0 0 0 0 0 0 0 0 0 0 0 0 0 0 0 0 0 0 0 0 0 0 0 0 0 0 0 0 0 0 0 0 0 
0 0 0 0 0 0 0 0 0 0 0 0 0 0 0 0 0 0 0 0 0 0 0 0 0 0 0 0 0 0 0 0 0 0 0 0 0 0 0 0 
0 0 0 0 0 0 0 0 0 0 0 0 0 0 0 0 0 0 8 8 0 0 0 0 0 0 0 0 0 0 0 0 0 0 8 8 0 0 0 0 
0 0 0 0 0 0 0 0 0 0 0 0 0 0 0 0 0 0 590 592 0 0 0 0 0 0 0 0 0 0 0 0 0 0 590 592 0 0 0 0 
0 0 0 0 0 0 0 0 0 0 0 0 0 0 0 0 0 0 630 632 0 0 0 0 0 0 0 0 0 0 0 0 0 0 630 632 0 0 0 0 
0 0 0 0 0 0 0 0 0 0 0 0 0 0 0 0 0 0 630 632 0 0 0 0 0 0 0 0 0 0 0 0 0 0 630 632 0 0 0 0 
0 0 0 0 0 0 0 0 0 0 0 0 0 0 8 8 8 8 630 632 8 8 8 8 8 8 8 8 8 8 8 8 8 8 630 632 0 0 0 0 
0 0 0 0 0 0 590 591 591 591 591 591 591 591 591 591 591 591 552 551 591 591 591 591 591 591 591 591 591 591 591 591 591 591 552 632 0 0 0 0 
0 0 0 0 0 0 630 510 511 671 671 671 671 671 671 671 671 671 671 671 671 671 671 671 671 671 671 671 671 671 671 512 510 510 510 632 0 0 0 0 
0 0 0 0 0 0 630 510 632 0 0 0 0 0 0 0 0 9 9 9 9 9 9 0 0 0 0 0 0 0 0 630 510 510 510 632 0 0 0 0 
0 0 0 0 0 0 630 510 632 0 0 0 0 0 0 0 0 0 0 0 0 0 0 0 0 0 0 0 0 0 0 630 510 510 510 632 0 0 0 0 
0 0 0 0 0 0 630 510 632 0 0 0 0 0 0 0 0 0 0 0 0 0 0 0 0 0 0 0 0 0 0 630 510 510 510 632 0 0 0 0 
0 0 0 0 0 0 630 510 632 0 0 0 0 778 779 779 779 779 779 779 779 779 779 779 779 779 780 0 0 0 0 630 510 510 510 632 0 0 0 0 
0 0 0 0 0 0 630 510 632 0 0 0 0 818 698 698 698 698 698 698 698 698 698 698 698 698 820 0 0 0 0 630 510 510 510 632 8 8 8 8 
0 0 0 0 0 0 630 510 632 0 0 0 0 818 698 698 698 698 698 698 698 698 698 698 698 698 820 0 0 0 0 630 510 510 510 551 591 591 591 591 
0 0 0 0 0 0 630 510 632 0 0 0 0 818 698 698 698 698 698 698 698 698 698 698 698 698 820 0 0 0 0 630 510 510 510 510 510 510 510 510 
0 0 0 0 590 591 552 510 632 0 0 0 0 818 698 698 0 0 0 0 0 0 0 0 698 698 820 0 0 0 0 630 510 510 510 510 510 510 510 510 
0 0 0 0 630 510 510 510 632 0 0 0 0 818 698 698 590 591 591 591 591 591 591 592 698 698 820 0 0 0 0 630 510 510 510 510 510 510 510 510 
8 8 8 8 630 510 510 510 632 0 0 0 0 818 698 698 630 510 510 510 510 510 510 632 698 698 820 0 0 0 0 630 510 510 510 510 510 510 510 510 
591 591 591 591 552 510 510 510 632 0 0 0 0 818 698 698 630 510 510 510 510 510 510 632 698 698 820 0 0 0 0 630 510 510 510 510 510 510 510 510 
510 510 510 510 510 510 510 510 632 0 0 0 0 818 698 698 630 510 510 510 510 510 510 632 698 698 820 0 0 0 0 630 510 510 510 510 510 510 510 510 
510 510 510 510 510 510 510 510 632 0 0 0 0 818 698 698 630 510 510 510 510 510 510 632 698 698 820 0 0 0 0 630 510 510 510 510 510 510 510 510 
12
4 21 9
2 14 2 6 4 0 0 320 240
0 14 2 6 4 0 0 320 240
0 13 2 7 4 0 0 320 240
32 2 2 7 4 0 0 320 240
12 4 2 3 4 0 0 320 240
30 11 2 2 4 0 0 320 240
16 23 2 7 4 0 0 320 240
19 21 10 1
9 16 2 8 4 0 0 320 240
23 16 2 8 4 0 0 320 240
6 13 2 7 4 0 0 320 240
