86 86 86 86 86 86 86 86 86 86 86 86 86 86 86 86 86 86 86 86 86 86 86 86 86 86 86 86 86 86 86 86 86 86 86 86 86 86 86 86 
86 86 86 86 86 86 86 86 86 86 86 86 86 86 86 86 86 86 86 86 86 86 86 86 86 86 86 86 86 86 86 86 86 86 86 86 86 86 86 86 
247 247 247 88 86 86 86 87 247 247 247 247 247 247 247 88 86 86 86 86 86 86 86 86 87 247 247 247 247 247 247 247 88 86 86 86 87 247 247 247 
9 9 9 206 86 86 86 208 9 9 9 9 9 9 9 206 86 86 86 86 86 86 86 86 208 9 9 9 9 9 9 9 206 86 86 86 208 9 9 9 
0 0 0 246 247 247 247 248 0 0 0 0 0 0 0 206 86 86 86 86 86 86 86 86 208 0 0 0 0 0 0 0 246 247 247 247 248 0 0 0 
0 0 0 0 0 0 0 0 0 0 0 0 0 0 0 246 247 247 247 247 247 247 247 247 248 0 0 0 0 0 0 0 0 0 0 0 0 0 0 0 
0 0 0 0 0 0 0 0 0 0 0 0 0 0 0 0 0 818 698 698 698 698 820 0 0 0 0 0 0 0 0 0 0 0 0 0 0 0 0 0 
0 0 0 0 0 0 0 0 0 0 0 0 0 0 0 0 0 818 698 698 698 698 820 0 0 0 0 0 0 0 0 0 0 0 0 0 0 0 0 0 
0 0 0 0 0 0 0 0 0 0 0 0 0 0 0 0 0 818 698 698 698 698 820 0 0 0 0 0 0 0 0 0 0 0 0 0 0 0 0 0 
0 0 0 0 0 0 0 0 0 0 0 0 0 0 0 0 0 818 698 698 698 698 820 0 0 0 0 0 0 0 0 0 0 0 0 0 0 0 0 0 
0 0 0 0 0 0 0 0 0 0 0 0 0 0 0 0 0 818 698 698 698 698 820 0 0 0 0 0 0 0 0 0 0 0 0 0 0 0 0 0 
0 0 0 0 0 0 0 0 0 0 0 0 0 0 0 0 0 858 859 859 859 859 860 0 0 0 0 0 0 0 0 0 0 0 0 0 0 0 0 0 
0 0 0 0 0 0 0 0 0 0 0 0 0 0 0 0 0 0 0 0 0 0 0 0 0 0 0 0 0 0 0 0 0 0 0 0 0 0 0 0 
0 0 0 0 0 0 0 0 0 0 0 0 0 0 0 0 0 0 0 0 0 0 0 0 0 0 0 0 0 0 0 0 0 0 0 0 0 0 0 0 
167 167 167 167 167 167 167 167 167 167 167 167 167 167 167 168 0 0 0 0 0 0 0 0 166 167 167 167 167 167 167 168 0 0 0 0 0 0 0 0 
86 86 86 86 86 86 86 86 86 87 247 247 247 88 86 208 0 0 0 0 0 0 0 0 206 86 87 247 247 247 88 127 167 168 0 0 0 0 0 0 
86 86 86 86 86 86 86 86 86 208 0 0 0 206 86 208 0 0 0 0 0 0 0 0 206 86 208 0 0 0 206 86 86 127 167 168 0 0 0 0 
86 86 86 86 86 86 86 86 86 208 0 0 0 206 86 208 8 8 8 8 8 8 8 8 206 86 208 0 0 0 206 86 86 86 86 127 167 168 0 0 
86 86 86 86 86 86 86 86 86 208 0 0 0 206 86 127 167 167 167 167 167 167 167 167 128 86 208 0 0 0 206 86 86 86 86 86 86 127 167 167 
86 86 86 86 86 86 86 86 86 208 779 779 779 206 86 86 86 86 86 86 86 86 86 86 86 86 208 779 779 779 206 86 86 86 86 86 86 86 86 86 
247 247 247 247 247 247 247 247 247 248 698 698 698 246 247 247 247 247 247 247 247 247 247 247 247 247 248 698 698 698 246 247 247 247 247 247 247 247 247 247 
0 0 0 0 0 0 0 0 0 0 698 698 698 0 0 0 0 0 0 0 0 0 0 0 0 0 0 698 698 698 0 0 0 0 0 0 0 0 0 0 
0 0 0 0 0 818 698 698 698 698 698 698 698 698 698 698 698 698 698 698 698 698 698 698 698 698 698 698 698 698 698 698 698 820 0 0 0 0 0 0 
0 0 0 0 0 858 859 859 859 859 859 859 859 859 859 859 859 859 859 859 859 859 859 859 859 859 859 859 859 859 859 859 859 860 0 0 0 0 0 0 
0 0 0 0 0 0 0 0 0 0 0 0 0 0 0 0 0 0 0 0 0 0 0 0 0 0 0 0 0 0 0 0 0 0 0 0 0 0 0 0 
0 0 0 0 0 0 0 0 0 0 0 0 0 0 0 0 0 0 0 0 0 0 0 0 0 0 0 0 0 0 0 0 0 0 0 0 0 0 0 0 
167 167 167 167 167 167 167 167 167 167 167 167 167 167 167 167 167 167 167 167 167 167 167 167 167 167 167 167 167 167 167 167 167 167 167 167 167 167 167 167 
86 86 86 86 86 86 86 86 86 86 86 86 86 86 86 86 86 86 86 86 86 86 86 86 86 86 86 86 86 86 86 86 86 86 86 86 86 86 86 86 
86 86 86 86 86 86 86 86 86 86 86 86 86 86 86 86 86 86 86 86 86 86 86 86 86 86 86 86 86 86 86 86 86 86 86 86 86 86 86 86 
10
0 21 2 8 4 0 0 320 240
9 8 1 3 4 64 56 256 104
29 10 1 2 4 64 56 256 104
6 21 2 6 4 0 0 320 240
13 21 2 8 4 0 0 320 240
19 21 2 8 4 0 0 320 240
30 21 2 8 4 0 0 320 240
36 21 2 6 4 0 0 320 240
20 23 1 3 4 160 0 320 240
18 23 1 2 4 0 0 160 240
