432 49 0 0 0 0 50 430 310 310 310 310 310 310 310 310 310 432 0 0 0 0 0 430 310 310 310 310 310 310 310 310 310 310 310 310 310 310 310 310 
432 49 0 0 0 0 50 430 310 310 310 310 310 310 310 310 310 432 0 0 0 0 0 430 310 310 310 310 310 310 310 310 310 310 310 310 310 310 310 310 
432 49 0 0 0 0 50 430 310 310 310 310 310 310 310 310 310 432 0 0 0 0 0 470 312 310 310 310 310 310 310 310 310 310 310 310 310 310 310 310 
432 49 0 0 0 0 50 430 310 310 310 310 310 310 310 310 310 432 0 0 0 0 0 9 470 312 310 310 310 310 310 310 310 310 310 310 310 310 310 310 
432 49 0 0 0 0 50 430 310 310 310 310 310 310 310 310 310 432 0 0 0 0 0 0 9 470 312 310 310 310 310 310 310 310 310 310 310 310 310 310 
432 49 0 0 0 0 50 430 310 310 310 310 310 310 310 310 310 432 0 0 0 0 0 0 0 9 470 471 312 310 310 310 310 310 310 310 310 310 310 310 
432 49 0 0 0 0 50 430 310 310 310 310 310 310 310 310 310 432 0 0 0 0 0 0 0 0 9 9 470 471 312 310 310 310 310 310 310 310 310 310 
432 49 0 0 0 0 50 430 310 310 310 310 310 310 310 310 310 432 0 0 0 0 0 0 0 0 0 0 9 9 470 471 312 310 310 310 310 310 310 310 
432 49 0 0 0 0 50 430 310 310 310 310 310 310 310 310 310 432 0 0 0 0 0 0 0 0 0 0 0 0 9 9 470 312 310 310 310 310 310 310 
432 49 0 0 0 0 50 430 310 310 310 310 310 310 310 310 310 432 0 0 0 0 0 0 0 0 0 0 0 0 0 0 50 430 310 310 310 310 310 310 
432 49 0 0 0 0 50 430 310 310 310 310 310 310 310 310 310 432 0 0 0 0 0 0 0 0 0 0 0 0 0 0 50 430 310 310 310 310 310 310 
432 49 0 0 0 0 50 430 310 310 310 310 310 310 310 310 310 432 0 0 0 0 0 0 0 0 0 0 0 0 0 0 50 430 310 310 310 310 310 310 
432 49 0 0 0 0 50 430 310 310 310 310 310 310 310 310 310 432 0 0 0 0 0 0 0 0 0 0 0 0 0 50 390 352 310 310 310 310 310 310 
432 49 0 0 0 0 50 430 310 310 310 310 310 310 310 310 310 432 8 8 8 8 8 0 0 0 0 0 0 0 0 50 430 310 310 310 310 310 310 310 
432 49 0 0 0 0 50 430 310 310 310 310 310 310 310 310 310 351 391 391 391 391 392 49 0 0 0 0 0 0 0 50 470 471 471 471 471 312 310 310 
432 49 0 0 0 0 50 430 310 310 310 310 310 310 310 310 310 310 310 310 310 310 432 49 0 0 0 0 0 0 0 0 9 9 9 9 9 430 310 310 
432 49 0 0 0 0 50 430 310 310 310 310 310 310 310 310 310 310 310 310 310 311 472 49 0 0 0 0 0 0 0 0 0 0 0 0 0 430 310 310 
432 49 0 0 0 0 50 430 310 310 310 310 310 310 310 310 310 310 310 310 310 432 49 0 0 0 0 0 0 0 0 0 0 0 0 0 0 430 310 310 
432 49 0 0 0 0 50 430 310 310 310 310 310 310 310 310 310 310 310 310 310 432 49 0 0 0 0 0 0 0 0 0 0 0 0 0 0 430 310 310 
432 49 0 0 0 0 50 430 310 310 310 310 310 310 310 310 310 310 310 310 310 432 49 0 0 0 0 0 0 0 0 0 0 0 0 0 0 430 310 310 
432 49 0 0 0 0 50 430 310 310 310 310 310 310 310 310 310 310 310 310 310 351 392 8 8 0 0 0 0 0 0 0 0 0 0 0 0 430 310 310 
432 49 0 0 0 0 50 430 310 310 310 310 310 310 310 310 310 310 310 310 310 310 351 391 392 8 8 0 0 0 0 0 0 0 0 0 0 430 310 310 
432 49 0 0 0 0 50 430 310 310 310 310 310 310 310 310 310 310 310 310 310 310 310 310 351 391 392 8 8 0 0 0 0 0 0 0 0 430 310 310 
432 49 0 0 0 0 50 430 310 310 310 310 310 310 310 310 310 310 310 310 310 310 310 310 310 310 351 391 392 8 0 0 0 0 0 0 0 430 310 310 
432 49 0 0 0 0 50 430 310 310 310 310 310 310 310 310 310 310 310 310 310 310 310 310 310 310 310 310 351 392 8 0 0 0 0 0 0 430 310 310 
432 49 0 0 0 0 50 430 310 310 310 310 310 310 310 310 310 310 310 310 310 310 310 310 310 310 310 310 310 351 392 8 0 0 0 0 0 430 310 310 
432 49 0 0 0 0 50 430 310 310 310 310 310 310 310 310 310 310 310 310 310 310 310 310 310 310 310 310 310 310 351 392 0 0 0 0 0 430 310 310 
432 49 0 0 0 0 50 430 310 310 310 310 310 310 310 310 310 310 310 310 310 310 310 310 310 310 310 310 310 310 310 432 0 0 0 0 0 430 310 310 
432 49 0 0 0 0 50 430 310 310 310 310 310 310 310 310 310 310 310 310 310 310 310 310 310 310 310 310 310 310 310 432 0 0 0 0 0 430 310 310 
0
