89 89 211 695 695 695 695 209 89 89 89 89 89 89 89 89 89 89 89 89 89 89 89 89 89 89 89 89 89 89 89 89 89 89 89 89 89 89 89 89 
89 89 211 695 695 695 695 209 89 89 89 89 89 89 89 89 89 89 89 89 89 89 89 89 89 89 89 89 89 89 89 89 89 89 89 89 89 89 89 89 
89 89 211 695 695 695 695 249 250 250 250 250 250 250 250 250 250 250 250 250 250 250 250 250 250 250 250 250 250 250 250 250 250 250 250 250 250 91 89 89 
89 89 211 695 695 695 695 695 695 817 0 0 0 0 0 0 0 0 0 0 0 0 0 0 0 0 0 0 0 0 815 695 695 695 695 695 695 209 89 89 
89 89 211 695 695 695 695 695 695 817 0 0 0 0 0 0 0 0 0 0 0 0 0 0 0 0 0 0 0 0 815 695 695 695 695 695 695 209 89 89 
89 89 211 695 695 695 695 695 695 817 0 0 0 0 0 0 0 0 0 0 0 0 0 0 0 0 0 0 0 0 815 695 695 695 695 695 695 209 89 89 
89 89 211 695 695 695 695 695 695 817 0 0 0 169 170 170 170 170 170 170 170 170 170 170 170 170 170 170 170 170 170 170 171 695 695 695 695 209 89 89 
89 89 211 695 695 695 695 695 695 817 0 0 0 209 89 89 89 89 89 89 89 89 89 89 89 89 89 89 89 89 89 89 211 695 695 695 695 209 89 89 
89 89 211 695 695 695 695 695 695 817 0 0 0 209 89 89 89 89 89 89 89 89 89 89 89 89 89 89 89 89 89 89 211 695 695 695 695 209 89 89 
89 89 211 695 695 695 695 695 695 817 0 0 0 249 250 250 250 250 250 250 250 250 250 250 250 250 250 250 250 250 250 250 251 695 695 695 695 209 89 89 
89 89 211 695 695 695 695 695 695 817 0 0 0 0 0 0 0 0 0 0 0 0 0 0 0 0 0 0 0 0 0 0 0 695 695 695 695 209 89 89 
89 89 211 695 695 695 695 695 695 817 0 0 0 0 0 0 0 0 0 0 0 0 0 0 0 0 0 0 0 0 815 695 695 695 695 695 695 209 89 89 
89 89 211 695 695 695 695 695 695 817 0 0 0 0 0 0 0 0 0 0 0 0 0 0 0 0 0 0 0 0 815 695 695 695 695 695 695 209 89 89 
89 89 211 695 695 695 695 695 695 817 0 0 0 0 0 0 0 0 0 0 0 0 0 0 0 0 0 0 0 0 815 695 695 695 695 695 695 209 89 89 
89 89 211 856 856 856 856 856 856 857 0 0 0 0 0 0 0 0 0 0 0 0 0 0 0 0 0 0 0 0 815 695 695 695 695 695 695 209 89 89 
89 89 211 0 0 0 0 0 0 0 0 0 0 0 0 0 0 0 0 0 0 0 0 0 0 0 0 0 0 0 815 695 695 695 695 695 695 209 89 89 
89 89 211 0 0 0 0 0 0 0 0 0 0 0 0 0 0 0 0 0 0 0 0 0 0 0 0 0 0 0 815 695 695 695 695 695 695 209 89 89 
89 89 211 0 0 0 0 0 0 0 0 0 0 0 0 0 0 0 0 0 0 0 0 0 0 0 0 0 0 0 815 695 695 695 695 695 695 209 89 89 
89 89 211 0 0 0 0 0 0 0 0 0 0 0 0 0 0 0 0 0 0 0 0 0 0 0 0 0 0 0 815 695 695 695 695 695 695 209 89 89 
89 89 211 0 0 0 0 169 170 170 170 170 170 170 170 170 170 170 170 170 170 170 170 170 170 170 171 0 0 0 815 695 695 695 695 695 695 209 89 89 
89 89 211 0 0 0 0 209 89 89 89 89 89 89 89 89 89 89 89 89 89 89 89 89 89 89 211 0 0 0 815 695 695 695 695 695 695 249 250 250 
89 89 211 0 0 0 0 209 89 89 89 89 89 89 89 89 89 89 89 89 89 89 89 89 89 89 211 0 0 0 815 695 695 695 695 695 695 695 695 695 
89 89 211 0 0 0 0 249 250 250 250 250 250 250 250 250 250 250 250 250 250 250 250 250 250 250 251 0 0 0 815 695 695 695 695 695 695 695 695 695 
89 89 211 0 0 0 0 0 0 0 0 0 0 0 0 0 0 0 0 0 0 0 0 0 0 0 0 0 0 0 855 856 856 856 856 856 856 856 856 856 
89 89 211 0 0 0 0 0 0 0 0 0 0 0 0 0 0 0 0 0 0 0 0 0 0 0 0 0 0 0 0 0 0 0 0 0 0 0 0 0 
89 89 211 0 0 0 0 0 0 0 0 0 0 0 0 0 0 0 0 0 0 0 0 0 0 0 0 0 0 0 0 0 0 0 0 0 0 0 0 0 
89 89 130 170 170 170 170 170 170 170 170 170 170 170 170 170 170 170 170 170 170 170 170 170 170 170 170 170 170 170 170 170 170 170 170 170 170 170 170 170 
89 89 89 89 89 89 89 89 89 89 89 89 89 89 89 89 89 89 89 89 89 89 89 89 89 89 89 89 89 89 89 89 89 89 89 89 89 89 89 89 
89 89 89 89 89 89 89 89 89 89 89 89 89 89 89 89 89 89 89 89 89 89 89 89 89 89 89 89 89 89 89 89 89 89 89 89 89 89 89 89 
10
19 4 10 1
19 23 10 0
34 15 1 2 8 0 0 320 240
4 12 1 3 8 0 0 320 240
13 10 2 7 4 0 0 320 240
21 10 2 7 4 0 0 320 240
29 10 2 5 4 0 0 320 240
7 18 2 7 4 0 0 320 240
15 18 2 7 4 0 0 320 240
23 18 2 5 4 0 0 320 240
