98 98 98 98 98 98 98 98 98 98 98 98 98 98 98 98 98 98 98 98 98 98 98 98 98 98 98 98 98 98 98 98 98 98 98 98 98 98 98 98 
259 259 259 259 259 259 259 259 259 259 259 259 100 98 98 98 98 98 98 98 98 98 98 98 98 98 98 99 259 259 259 259 259 259 259 259 100 98 98 98 
9 9 9 9 9 9 9 9 9 9 9 9 258 259 259 259 259 259 259 259 259 259 259 259 259 259 259 260 7 7 7 7 7 7 7 7 218 98 98 98 
0 0 0 0 0 0 0 0 0 0 0 0 0 0 0 0 0 0 0 0 0 0 0 0 0 0 0 0 680 680 680 680 680 680 680 680 218 98 98 98 
0 0 0 0 0 0 0 0 0 0 0 0 0 0 0 0 0 0 0 0 0 0 0 0 0 800 680 680 680 680 680 680 680 680 680 680 218 98 98 98 
0 0 0 0 0 0 0 0 0 0 0 0 0 0 0 0 0 0 0 0 0 0 0 0 0 800 680 680 680 680 680 680 680 680 680 680 218 98 98 98 
0 0 0 0 0 0 0 0 0 0 0 0 0 0 0 0 0 0 0 0 0 0 0 0 0 800 680 680 680 680 680 680 680 680 680 680 218 98 98 98 
0 0 0 0 0 0 0 0 0 0 0 0 0 0 0 0 0 0 0 0 0 0 0 0 0 800 680 680 680 680 680 680 680 680 680 680 218 98 98 98 
0 0 0 0 0 0 0 0 0 0 0 0 0 0 0 0 0 0 0 0 0 0 0 0 0 800 680 680 680 680 680 680 680 680 680 680 218 98 98 98 
0 0 0 0 0 0 0 0 0 0 0 0 0 0 0 0 0 0 0 0 0 0 0 0 0 0 0 0 0 0 0 0 680 680 680 680 218 98 98 98 
179 179 179 179 179 179 179 179 179 179 179 179 179 179 179 180 8 8 8 8 8 8 8 8 178 179 179 179 179 179 179 180 680 680 680 680 218 98 98 98 
98 98 98 98 98 98 98 98 98 98 98 98 98 98 98 139 179 179 179 179 179 179 179 179 140 98 98 98 98 98 98 220 680 680 680 680 218 98 98 98 
98 98 98 98 98 98 98 98 98 98 98 98 98 98 98 99 259 259 259 259 259 259 259 259 100 98 98 98 98 98 98 220 680 680 680 680 218 98 98 98 
259 259 259 259 259 259 259 259 259 259 259 259 259 259 259 260 9 9 9 9 9 9 9 9 258 259 259 259 100 98 98 220 680 680 680 680 218 98 98 98 
0 0 0 0 0 0 0 0 0 0 0 0 0 0 0 0 0 0 0 0 0 0 0 0 0 0 0 0 218 98 98 220 680 680 680 680 218 98 98 98 
0 0 0 0 0 0 0 0 0 0 0 0 0 0 0 0 0 0 0 0 0 0 0 0 0 800 680 680 218 98 98 220 680 680 680 680 218 98 98 98 
0 0 0 0 0 0 0 0 0 0 0 0 0 0 0 0 0 0 0 0 0 0 0 0 0 800 680 680 218 98 98 220 680 680 680 680 218 98 98 98 
0 0 0 0 0 0 0 0 0 0 0 0 0 0 0 0 0 0 0 0 0 0 0 0 0 800 680 680 218 98 98 220 680 680 680 680 218 98 98 98 
0 0 0 0 0 0 0 0 0 0 0 0 0 0 0 0 0 0 0 0 0 0 0 0 0 800 680 680 218 98 98 220 680 680 680 680 218 98 98 98 
0 0 0 0 0 0 0 0 0 0 0 0 0 0 0 0 0 0 0 0 0 0 0 0 0 800 680 680 218 98 98 220 680 680 680 680 218 98 98 98 
0 0 0 0 0 0 0 0 0 0 0 0 0 0 0 0 0 0 0 0 0 0 0 0 0 800 680 680 218 98 98 220 680 680 680 680 218 98 98 98 
0 0 0 0 0 0 0 0 0 0 0 0 0 0 0 0 0 0 0 0 0 0 0 0 0 800 680 680 218 98 98 220 680 680 680 680 218 98 98 98 
179 179 179 180 0 0 0 0 0 0 0 0 0 0 0 0 0 0 0 0 0 0 0 0 0 800 680 680 218 98 98 220 680 680 680 680 218 98 98 98 
98 98 98 220 0 0 0 0 0 0 0 0 0 0 0 0 0 0 0 0 0 0 0 0 0 840 841 841 218 98 98 220 841 841 841 841 218 98 98 98 
98 98 98 220 0 0 0 0 0 0 0 0 0 0 0 0 0 0 0 0 0 0 0 0 0 0 0 0 218 98 98 220 0 0 0 0 218 98 98 98 
98 98 98 220 0 0 0 0 0 0 0 0 0 0 0 0 0 0 0 0 0 0 0 0 0 0 0 0 218 98 98 220 0 0 0 0 218 98 98 98 
98 98 98 220 0 0 0 0 0 0 0 0 0 0 0 0 0 0 0 0 0 0 0 0 0 0 0 0 218 98 98 220 0 0 0 0 218 98 98 98 
98 98 98 220 0 0 0 0 0 0 0 0 0 0 0 0 0 0 0 0 0 0 0 0 0 0 0 0 218 98 98 220 0 0 0 0 218 98 98 98 
98 98 98 220 0 0 0 0 178 179 179 179 179 179 179 179 179 179 179 179 179 179 179 179 179 179 179 179 140 98 98 220 0 0 0 0 218 98 98 98 
17
0 9 2 7 4 0 0 320 240
12 3 2 7 4 0 0 320 240
20 3 2 7 4 0 0 320 240
8 21 2 7 4 0 0 320 240
16 21 2 7 4 0 0 320 240
8 20 2 7 4 0 0 320 240
16 20 2 7 4 0 0 320 240
0 20 2 7 4 0 0 320 240
0 14 2 7 4 0 0 320 240
8 14 2 7 4 0 0 320 240
8 27 2 7 4 0 0 320 240
16 27 2 7 4 0 0 320 240
24 27 2 5 4 0 0 320 240
0 21 2 7 4 0 0 320 240
8 9 2 7 4 0 0 320 240
24 9 2 7 4 0 0 320 240
24 14 2 5 4 0 0 320 240
