92 92 92 92 92 92 214 683 683 683 683 683 252 253 94 92 92 92 92 92 214 0 0 0 0 212 92 92 92 92 92 92 92 92 92 92 92 92 92 92 
92 92 92 92 92 92 214 683 683 683 683 683 683 683 212 92 92 92 92 92 214 0 0 0 0 212 92 92 92 92 92 92 92 92 92 92 92 92 92 92 
92 92 92 92 92 92 214 683 683 683 683 683 683 683 212 92 92 92 92 92 214 0 0 0 0 212 92 92 92 92 92 92 92 92 92 92 92 92 92 92 
92 92 92 92 92 92 214 683 683 683 683 683 683 683 212 92 92 92 92 92 214 0 0 0 0 212 92 92 92 92 92 92 92 92 92 92 92 92 92 92 
92 92 92 92 92 92 214 683 683 683 683 683 683 683 212 92 92 92 92 92 214 0 0 0 0 212 92 92 92 92 92 92 92 92 92 92 92 92 92 92 
92 92 92 92 92 92 214 683 683 683 683 683 683 683 212 92 92 92 92 92 214 0 0 0 0 212 92 92 92 92 92 92 92 92 92 92 92 92 92 92 
92 92 92 92 92 92 214 683 683 683 683 683 683 683 212 92 92 92 92 92 214 0 0 0 0 212 92 92 92 92 92 92 92 92 92 92 92 92 92 92 
92 92 92 92 92 92 214 683 683 683 683 683 172 173 134 92 92 92 92 92 214 0 0 0 0 212 92 92 92 92 92 92 92 92 92 92 92 92 92 92 
92 92 92 92 92 92 214 683 683 683 683 683 212 92 92 92 92 92 92 92 214 0 0 0 0 212 92 92 92 92 92 92 92 92 92 92 92 92 92 92 
92 92 92 92 92 92 214 683 683 683 683 683 212 92 92 92 92 92 92 92 214 0 0 0 0 252 253 253 253 253 253 253 253 253 253 253 253 253 253 253 
92 92 92 92 93 253 254 683 683 683 683 683 212 92 92 92 92 92 92 92 214 0 0 0 0 0 0 0 0 0 0 0 0 0 0 0 0 0 0 0 
92 92 92 92 214 683 683 683 683 683 683 683 212 92 92 92 92 92 92 92 214 0 0 0 0 0 0 0 0 0 0 0 0 0 0 0 0 0 0 0 
92 92 92 92 214 683 683 683 683 683 683 683 212 92 92 92 92 92 92 92 214 0 0 0 0 0 0 0 0 0 0 0 0 0 0 0 0 0 0 0 
92 92 92 92 214 683 683 683 683 683 683 683 212 92 92 92 92 92 92 92 214 0 0 0 0 0 0 0 0 0 0 0 0 0 0 0 0 0 0 0 
92 92 92 92 214 683 683 683 683 683 683 683 212 92 92 92 92 92 92 92 133 173 173 173 173 173 173 173 173 173 173 173 173 173 173 173 173 173 173 173 
92 92 92 92 214 683 683 683 683 683 683 683 212 92 92 92 92 92 92 92 92 92 92 92 92 92 92 92 92 92 92 92 92 92 92 92 92 92 92 92 
92 92 92 92 214 683 683 683 683 683 683 683 212 92 92 92 92 92 92 92 92 92 92 92 92 92 92 92 92 92 92 92 92 92 92 92 92 92 92 92 
92 92 92 92 133 173 174 683 683 683 683 683 212 92 92 92 92 92 92 92 92 92 92 92 92 92 92 92 92 92 92 92 92 92 92 92 92 92 92 92 
92 92 92 92 92 92 214 683 683 683 683 683 212 92 92 92 92 92 92 92 92 92 92 92 92 92 92 92 92 92 92 92 92 92 92 92 92 92 92 92 
92 92 92 92 92 92 214 683 683 683 683 683 212 92 92 92 92 92 92 92 92 92 92 92 92 92 92 92 92 92 92 92 92 92 92 92 92 92 92 92 
92 92 92 92 92 92 214 683 683 683 683 683 252 253 94 92 92 92 92 92 92 92 92 92 92 92 92 92 92 92 92 92 92 92 92 92 92 92 92 92 
92 92 92 92 92 92 214 683 683 683 683 683 683 683 212 92 92 92 92 92 92 92 92 92 92 92 92 92 92 92 92 92 92 92 92 92 92 92 92 92 
92 92 92 92 92 92 214 683 683 683 683 683 683 683 212 92 92 92 92 92 92 92 92 92 92 92 92 92 92 92 92 92 92 92 92 92 92 92 92 92 
92 92 92 92 92 92 214 683 683 683 683 683 683 683 212 92 92 92 92 92 92 92 92 92 92 92 92 92 92 92 92 92 92 92 92 92 92 92 92 92 
92 92 92 92 92 92 214 683 683 683 683 683 683 683 212 92 92 92 92 92 92 92 92 92 92 92 92 92 92 92 92 92 92 92 92 92 92 92 92 92 
92 92 92 92 92 92 214 683 683 683 683 683 683 683 212 92 92 92 92 92 92 92 92 92 92 92 92 92 92 92 92 92 92 92 92 92 92 92 92 92 
92 92 92 92 92 92 214 683 683 683 683 683 683 683 212 92 92 92 92 92 92 92 92 92 92 92 92 92 92 92 92 92 92 92 92 92 92 92 92 92 
92 92 92 92 92 92 214 683 683 683 683 683 172 173 134 92 92 92 92 92 92 92 92 92 92 92 92 92 92 92 92 92 92 92 92 92 92 92 92 92 
92 92 92 92 92 92 214 683 683 683 683 683 212 92 92 92 92 92 92 92 92 92 92 92 92 92 92 92 92 92 92 92 92 92 92 92 92 92 92 92 
1
12 21 10 0
