86 86 86 86 86 86 86 86 86 86 86 86 86 86 86 86 86 86 86 86 86 86 86 86 86 86 86 86 86 86 86 86 86 86 86 86 86 86 86 86 
86 86 86 86 86 86 86 86 86 86 86 86 86 86 86 86 86 86 86 86 86 86 86 86 86 86 86 86 86 86 86 86 86 86 86 86 86 86 86 86 
86 86 86 86 86 86 86 87 247 247 247 247 247 247 247 247 247 88 87 247 247 247 247 247 247 247 88 87 247 247 247 247 247 247 247 247 247 88 86 86 
86 86 86 86 86 86 86 208 9 9 9 9 9 9 9 9 9 206 208 9 9 9 9 9 9 9 206 208 9 9 9 9 9 9 9 9 9 206 86 86 
86 86 86 86 86 86 86 208 0 0 0 0 0 0 0 0 0 206 208 0 0 0 0 0 0 0 206 208 0 0 0 0 0 0 0 0 0 206 86 86 
86 86 86 86 86 86 86 208 0 0 0 0 0 0 0 0 0 246 248 0 0 0 0 0 0 0 246 248 0 0 0 0 0 0 0 0 0 206 86 86 
247 247 247 247 247 247 88 208 0 0 0 0 0 0 0 0 0 0 0 0 0 0 0 0 0 0 0 0 0 0 0 0 0 0 0 0 0 206 86 86 
0 0 0 0 0 0 206 208 0 0 0 0 0 0 0 0 0 166 168 0 0 0 0 0 0 0 166 168 0 0 0 0 0 0 0 0 0 206 86 86 
0 0 0 0 0 0 246 248 0 0 0 0 0 0 0 0 0 246 248 0 0 0 0 0 0 0 246 248 0 0 0 0 0 0 0 0 0 206 86 86 
0 0 0 0 0 0 9 9 0 0 0 0 0 0 0 0 0 9 9 0 0 0 0 0 0 0 9 9 0 0 0 0 0 0 0 0 0 206 86 86 
0 0 0 0 0 0 0 0 0 0 0 0 0 0 0 0 0 0 0 0 0 0 0 0 0 0 0 0 0 0 0 0 0 0 0 0 0 206 86 86 
0 0 0 0 0 0 0 0 0 0 0 0 0 0 0 0 0 0 0 0 0 0 0 0 0 0 0 0 0 0 0 0 0 0 0 0 0 206 86 86 
0 0 0 0 0 0 0 0 0 0 0 0 0 0 0 0 0 0 0 0 0 0 0 0 0 0 0 0 0 0 0 0 0 0 0 0 0 206 86 86 
0 0 0 0 778 779 779 779 779 779 779 779 779 779 779 779 779 779 779 779 779 779 779 779 779 779 779 779 779 779 779 779 779 779 779 779 779 206 86 86 
0 0 0 0 818 698 698 698 698 698 698 698 698 698 698 698 698 698 698 698 698 698 698 698 698 698 698 698 698 698 698 698 698 698 698 698 698 206 86 86 
0 0 0 0 818 698 698 698 698 698 698 698 698 698 698 698 698 698 698 698 698 698 698 698 698 698 698 698 698 698 698 698 698 698 698 698 698 206 86 86 
0 0 0 0 818 698 698 698 698 698 698 698 698 698 698 698 698 698 698 698 698 698 698 698 698 698 698 698 698 698 698 698 698 698 698 698 698 206 86 86 
0 0 0 0 818 698 698 698 698 698 698 698 698 698 698 698 698 698 698 698 698 698 698 698 698 698 698 698 698 698 698 698 698 698 698 698 698 206 86 86 
0 0 0 0 818 698 698 698 698 698 698 698 698 698 698 698 698 698 698 698 698 698 698 698 698 698 698 698 698 698 698 698 698 698 698 698 698 206 86 86 
0 0 0 0 818 698 698 698 698 698 698 698 698 698 698 698 698 698 698 698 698 698 698 698 698 698 698 698 698 698 698 698 698 698 698 698 698 206 86 86 
0 0 0 0 818 698 698 698 698 698 698 698 698 698 698 698 698 698 698 698 698 698 698 698 698 698 698 698 698 698 698 698 698 698 698 698 698 206 86 86 
0 0 0 0 818 698 698 698 698 698 698 698 698 698 698 698 698 698 698 698 698 698 698 698 698 698 698 698 698 698 698 698 698 698 698 698 698 206 86 86 
167 167 167 167 167 167 167 167 167 167 167 167 168 698 698 698 166 167 167 167 168 698 698 698 166 167 167 167 168 698 698 698 166 167 167 167 167 128 86 86 
86 86 86 86 86 86 86 86 86 86 86 86 208 698 698 698 206 86 86 86 208 698 698 698 206 86 86 86 208 698 698 698 206 86 86 86 86 86 86 86 
86 86 86 86 86 86 86 86 86 86 86 86 208 698 698 698 206 86 86 86 208 698 698 698 206 86 86 86 208 698 698 698 206 86 86 86 86 86 86 86 
86 86 86 86 86 86 86 86 86 86 86 86 208 698 698 698 206 86 86 86 208 698 698 698 206 86 86 86 208 698 698 698 206 86 86 86 86 86 86 86 
86 86 86 86 86 86 86 86 86 86 86 86 208 698 698 698 206 86 86 86 208 698 698 698 206 86 86 86 208 698 698 698 206 86 86 86 86 86 86 86 
86 86 86 86 86 86 86 86 86 86 86 86 127 167 167 167 128 86 86 86 127 167 167 167 128 86 86 86 127 167 167 167 128 86 86 86 86 86 86 86 
86 86 86 86 86 86 86 86 86 86 86 86 86 86 86 86 86 86 86 86 86 86 86 86 86 86 86 86 86 86 86 86 86 86 86 86 86 86 86 86 
5
14 25 1 1 6 104 144 264 240
22 19 1 0 6 104 144 264 240
30 25 1 1 6 104 144 264 240
8 6 2 3 4 0 0 320 240
34 19 9
