286 286 408 686 686 686 686 686 686 808 0 0 0 0 0 0 0 0 0 0 0 0 0 0 0 0 0 806 686 686 686 686 686 686 686 686 686 406 286 286 
286 286 408 686 686 686 686 686 686 808 0 0 0 0 0 0 0 0 0 0 0 0 0 0 0 0 0 806 686 686 686 686 686 686 686 686 686 406 286 286 
286 286 408 686 686 686 686 686 686 808 0 0 0 0 0 0 0 0 0 0 0 0 0 0 0 0 0 806 686 686 686 686 686 686 686 686 686 406 286 286 
286 286 408 686 686 686 686 686 686 808 0 0 0 0 0 0 0 0 0 0 0 0 0 0 0 0 0 806 686 686 686 686 686 686 686 686 686 406 286 286 
286 286 408 686 686 686 686 686 686 808 0 0 0 0 0 0 0 0 0 0 0 0 0 0 0 0 0 806 686 686 686 686 686 686 686 686 686 406 286 286 
286 286 408 686 686 686 686 686 686 808 0 0 0 0 0 0 0 0 0 0 0 0 0 0 0 0 0 806 686 686 686 686 686 686 686 686 686 406 286 286 
286 286 408 686 686 686 686 686 686 808 0 0 0 0 0 0 0 0 0 0 0 0 0 0 0 0 0 806 686 686 686 686 686 686 686 686 686 406 286 286 
286 286 408 686 686 686 686 686 686 808 0 0 0 0 0 0 0 0 0 0 0 0 0 0 0 0 0 846 847 847 847 847 847 847 847 847 847 406 286 286 
286 286 408 686 686 686 686 686 686 808 0 0 0 0 0 0 0 0 0 0 0 0 0 0 0 0 0 0 0 0 0 0 0 0 0 0 0 406 286 286 
286 286 408 686 686 686 686 686 686 808 0 0 0 0 0 0 0 0 0 0 0 0 0 0 0 0 0 0 0 0 0 0 0 0 0 0 0 406 286 286 
286 286 327 367 367 367 367 367 367 367 367 367 367 367 368 0 0 0 0 0 0 0 0 0 0 0 0 0 0 0 0 0 0 0 0 0 0 406 286 286 
286 286 286 286 286 286 286 286 286 286 286 286 286 286 408 0 0 0 0 0 0 0 0 0 0 0 0 0 0 0 0 0 0 0 0 0 0 406 286 286 
447 447 447 447 447 447 447 447 288 286 286 286 286 286 408 0 0 0 0 0 0 0 0 0 0 0 0 0 0 0 0 0 0 0 0 0 0 406 286 286 
686 686 686 686 686 686 686 686 406 286 286 286 286 286 408 0 0 0 0 0 0 0 0 0 0 0 0 0 0 0 0 0 0 0 0 0 0 406 286 286 
686 686 686 686 686 686 686 686 406 286 286 286 286 286 408 0 0 0 0 0 0 0 0 0 0 0 0 0 0 0 0 0 0 0 0 0 0 406 286 286 
686 686 686 686 686 686 686 686 446 447 447 447 447 447 448 0 0 0 0 0 0 0 0 0 0 0 0 0 0 0 0 0 0 0 0 0 0 406 286 286 
686 686 686 686 686 686 686 686 686 808 0 0 0 0 0 0 0 0 0 0 0 0 0 0 0 0 0 0 0 0 0 0 0 0 0 0 0 406 286 286 
686 686 686 686 686 686 686 686 686 808 0 0 0 0 0 0 0 0 0 0 0 0 0 0 0 0 0 0 0 0 0 0 0 0 0 0 0 406 286 286 
686 686 686 686 686 686 686 686 686 808 0 0 0 0 0 0 0 0 0 0 0 0 0 0 0 0 0 0 0 0 0 0 0 0 0 0 0 406 286 286 
686 686 686 686 686 686 686 686 686 808 0 0 0 0 0 0 0 0 0 0 0 0 0 0 0 0 0 0 0 0 0 0 0 0 0 0 0 406 286 286 
686 686 686 686 686 686 686 686 686 808 0 0 0 0 0 0 0 0 0 0 0 0 0 0 0 0 0 0 0 0 0 0 0 0 0 0 0 406 286 286 
686 686 686 686 686 686 686 686 686 808 0 0 0 0 0 0 0 0 0 0 0 0 0 0 0 0 0 0 0 0 0 0 0 0 0 0 0 406 286 286 
686 686 686 686 686 686 686 686 686 808 0 0 0 0 0 0 0 0 0 0 0 0 0 0 0 0 0 0 0 0 0 0 0 0 0 0 0 406 286 286 
367 367 367 367 367 367 367 367 367 367 367 367 367 367 367 367 367 367 367 367 367 367 367 367 367 367 367 367 367 367 367 367 367 367 367 367 367 328 286 286 
286 286 286 286 286 286 286 286 286 286 286 286 286 286 286 286 286 286 286 286 286 286 286 286 286 286 286 286 286 286 286 286 286 286 286 286 286 286 286 286 
286 286 286 286 286 286 286 286 286 286 286 286 286 286 286 286 286 286 286 286 286 286 286 286 286 286 286 286 286 286 286 286 286 286 286 286 286 286 286 286 
286 286 286 286 286 286 286 286 286 286 286 286 286 286 286 286 286 286 286 286 286 286 286 286 286 286 286 286 286 286 286 286 286 286 286 286 286 286 286 286 
286 286 286 286 286 286 286 286 286 286 286 286 286 286 286 286 286 286 286 286 286 286 286 286 286 286 286 286 286 286 286 286 286 286 286 286 286 286 286 286 
286 286 286 286 286 286 286 286 286 286 286 286 286 286 286 286 286 286 286 286 286 286 286 286 286 286 286 286 286 286 286 286 286 286 286 286 286 286 286 286 
1
19 21 10 1
