292 292 292 292 292 292 292 292 292 292 292 292 292 292 292 292 292 292 292 292 292 292 292 292 292 292 292 292 292 292 292 292 292 292 292 292 292 292 292 292 
292 292 292 292 292 292 292 292 292 292 292 292 292 292 292 292 292 292 292 292 292 292 292 292 292 292 292 292 292 292 292 292 292 292 292 292 292 292 292 292 
453 453 453 453 453 453 453 453 453 453 453 453 453 453 453 453 453 453 453 453 453 453 453 453 453 453 453 453 453 453 453 453 453 453 453 453 453 453 453 453 
0 0 0 818 698 698 698 698 698 698 698 698 698 698 698 820 0 0 9 9 9 9 0 0 818 698 698 698 698 698 698 698 698 698 698 698 820 0 0 0 
0 0 0 818 698 698 698 698 698 698 698 698 698 698 698 820 0 0 0 0 0 0 0 0 818 698 698 698 698 698 698 698 698 698 698 698 820 0 0 0 
0 0 0 818 698 698 698 698 698 698 698 698 698 698 698 820 0 0 0 0 0 0 0 0 818 698 698 698 698 698 698 698 698 698 698 698 820 0 0 0 
0 0 0 818 698 698 698 698 698 698 698 698 698 698 698 820 0 0 0 0 0 0 0 0 818 698 698 698 698 698 698 698 698 698 698 698 820 0 0 0 
0 0 0 818 698 698 698 698 698 698 698 698 698 698 698 820 0 0 0 0 0 0 0 0 818 698 698 698 698 698 698 698 698 698 698 698 820 0 0 0 
0 0 0 818 698 698 698 698 698 698 698 698 698 698 698 820 0 0 0 0 0 0 0 0 818 698 698 698 698 698 698 698 698 698 698 698 820 0 0 0 
0 0 0 818 698 698 698 698 698 698 698 698 698 698 698 820 0 0 0 0 0 0 0 0 818 698 698 698 698 698 698 698 698 698 698 698 820 0 0 0 
0 0 0 818 698 698 698 698 698 698 698 698 698 698 698 820 0 0 0 0 0 0 0 0 818 698 698 698 698 698 698 698 698 698 698 698 820 0 0 0 
0 0 0 818 698 698 698 698 698 698 698 698 698 698 698 820 0 0 0 0 0 0 0 0 818 698 698 698 698 698 698 698 698 698 698 698 820 0 0 0 
0 0 0 858 859 859 859 859 859 859 859 859 859 859 859 860 0 0 0 0 0 0 0 0 858 859 859 859 859 859 859 859 859 859 859 859 860 0 0 0 
0 0 0 0 0 0 0 0 0 0 0 0 0 0 0 0 0 0 0 0 0 0 0 0 0 0 0 0 0 0 0 0 0 0 0 0 0 0 0 0 
0 0 0 0 0 0 0 0 0 0 0 0 0 0 0 0 0 0 0 0 0 0 0 0 0 0 0 0 0 0 0 0 0 0 0 0 0 0 0 0 
0 0 0 0 0 0 0 0 0 0 0 0 0 0 0 0 0 0 0 0 0 0 0 0 0 0 0 0 0 0 0 0 0 0 0 0 0 0 0 0 
0 0 0 0 0 0 0 0 0 0 0 0 0 0 0 0 0 0 0 0 0 0 0 0 0 0 0 0 0 0 0 0 0 0 0 0 0 0 0 0 
0 0 0 0 0 0 0 0 0 0 0 0 0 0 0 0 0 0 0 0 0 0 0 0 0 0 0 0 0 0 0 0 0 0 0 0 0 0 0 0 
8 8 8 8 8 8 8 8 8 8 8 8 8 8 8 8 8 8 0 0 0 0 8 8 8 8 8 8 8 8 8 8 8 8 8 8 8 8 8 8 
373 373 373 373 373 373 373 373 373 373 373 373 373 373 373 373 373 374 0 0 0 0 372 373 373 373 373 373 373 373 373 373 373 373 373 373 373 373 373 373 
292 292 292 292 292 292 292 292 292 292 292 292 292 292 292 292 292 414 0 0 0 0 412 292 292 292 292 292 292 292 292 292 292 292 292 292 292 292 292 292 
292 292 292 292 292 292 292 292 292 292 292 292 292 292 292 292 292 414 0 0 0 0 412 292 292 292 292 292 292 292 292 292 292 292 292 292 292 292 292 292 
292 292 292 292 292 292 292 292 292 292 292 292 292 292 292 292 292 414 0 0 0 0 412 292 292 292 292 292 292 292 292 292 292 292 292 292 292 292 292 292 
292 292 292 292 292 292 292 292 292 292 292 292 292 292 292 292 292 414 0 0 0 0 412 292 292 292 292 292 292 292 292 292 292 292 292 292 292 292 292 292 
292 292 292 292 292 292 292 292 292 292 292 292 292 292 292 292 292 414 0 0 0 0 412 292 292 292 292 292 292 292 292 292 292 292 292 292 292 292 292 292 
292 292 292 292 292 292 292 292 292 292 292 292 292 292 292 292 292 414 0 0 0 0 412 292 292 292 292 292 292 292 292 292 292 292 292 292 292 292 292 292 
292 292 292 292 292 292 292 292 292 292 292 292 292 292 292 292 292 414 0 0 0 0 412 292 292 292 292 292 292 292 292 292 292 292 292 292 292 292 292 292 
292 292 292 292 292 292 292 292 292 292 292 292 292 292 292 292 292 414 0 0 0 0 412 292 292 292 292 292 292 292 292 292 292 292 292 292 292 292 292 292 
292 292 292 292 292 292 292 292 292 292 292 292 292 292 292 292 292 414 0 0 0 0 412 292 292 292 292 292 292 292 292 292 292 292 292 292 292 292 292 292 
2
5 3 10 0
33 3 10 0
