86 86 86 86 86 86 86 86 86 86 86 86 86 86 86 86 86 86 86 86 86 86 86 86 86 86 86 86 86 86 86 86 86 86 86 86 86 86 86 86 
86 86 86 86 86 86 86 86 86 86 86 86 86 86 86 86 86 86 87 247 247 247 247 247 247 247 247 247 247 247 247 247 247 247 247 247 247 247 247 247 
247 247 247 247 247 247 88 86 86 86 86 86 86 86 86 86 86 86 208 0 0 0 0 0 0 0 0 0 0 0 0 0 0 0 0 0 0 0 0 0 
0 0 0 0 0 0 246 247 247 247 247 88 86 86 86 86 86 86 208 698 698 698 698 698 698 698 698 698 698 698 698 698 820 0 0 0 0 0 0 0 
0 0 0 0 0 0 0 0 0 0 818 246 247 88 86 86 86 86 208 698 698 698 698 698 698 698 698 698 698 698 698 698 820 0 0 0 0 0 0 0 
0 0 0 0 0 0 0 0 0 0 818 698 698 246 247 88 86 86 208 698 698 698 698 698 698 698 698 698 698 698 698 698 820 0 0 0 0 0 0 0 
0 0 0 0 0 0 0 0 0 0 818 698 698 698 698 246 88 86 208 698 698 698 698 698 698 698 698 698 698 698 698 698 820 0 0 0 0 0 0 0 
0 0 0 0 0 0 0 0 0 0 818 698 698 698 698 698 206 86 208 698 698 698 698 698 0 0 0 0 0 0 0 0 0 0 0 0 0 0 0 0 
0 0 0 0 0 0 0 0 0 0 818 698 698 698 698 698 206 86 208 698 698 698 698 166 167 167 167 167 167 167 167 167 167 167 167 167 167 167 167 167 
0 0 0 0 0 0 0 0 0 0 818 698 698 698 698 698 206 86 208 698 698 698 698 206 86 86 86 86 86 86 86 86 86 86 86 86 86 86 86 86 
0 0 0 0 0 0 0 0 0 0 818 698 698 698 698 698 206 86 208 698 698 698 698 206 86 86 86 86 86 87 247 247 247 247 247 247 247 247 247 247 
0 0 0 0 0 0 0 0 0 0 818 698 698 698 698 698 206 86 208 698 698 698 698 206 86 86 86 86 86 208 0 0 0 0 0 0 0 0 0 0 
0 0 0 0 0 0 0 0 0 0 818 698 698 698 698 698 206 86 208 698 698 698 698 206 86 86 86 86 86 208 698 698 820 0 0 0 0 0 0 0 
0 0 0 0 0 0 0 0 0 0 818 698 698 698 698 698 206 86 208 698 698 698 698 206 86 86 86 86 86 208 698 698 820 0 0 0 0 0 0 0 
0 0 0 0 0 0 0 0 0 0 818 698 698 698 698 166 128 86 208 698 698 698 698 206 86 86 86 86 86 208 698 698 820 0 0 0 0 0 0 0 
0 0 0 0 0 0 0 0 0 0 818 698 698 698 166 128 86 86 208 698 698 698 698 206 86 86 86 86 86 208 698 698 820 0 0 0 0 0 0 0 
0 0 0 0 0 0 0 0 0 166 167 167 167 167 128 86 86 86 208 698 698 698 698 206 86 86 86 86 86 208 698 698 820 0 0 0 0 0 0 0 
0 0 0 0 0 166 167 167 167 128 86 86 86 86 86 86 86 86 208 698 698 698 698 206 86 86 86 86 86 208 698 698 820 0 0 166 167 167 167 167 
0 0 0 0 0 206 86 87 247 247 247 247 247 247 247 247 247 247 248 698 698 698 698 206 86 86 86 86 86 208 698 698 820 0 0 206 86 86 86 86 
0 0 0 0 0 206 86 208 0 0 0 0 0 0 0 0 0 0 0 698 698 698 698 206 86 86 86 86 86 208 698 698 820 0 0 206 86 86 86 86 
0 0 0 0 0 206 86 208 0 0 818 698 698 698 698 698 698 698 698 698 698 698 698 206 86 86 86 86 86 208 698 698 820 0 0 206 86 86 86 86 
0 0 0 0 0 206 86 208 0 0 818 698 698 698 698 698 698 698 698 698 698 698 698 206 86 86 86 86 86 208 698 698 820 0 0 206 86 86 86 86 
0 0 0 0 0 206 86 208 0 0 818 698 698 698 698 698 698 698 698 698 698 698 698 206 86 86 86 86 86 208 698 698 820 0 0 206 86 86 86 86 
0 0 0 0 0 206 86 208 0 0 818 698 698 698 698 698 698 698 698 698 698 698 698 206 86 86 86 86 86 208 698 698 820 0 0 206 86 86 86 86 
0 0 0 0 0 206 86 208 0 0 818 698 0 0 0 0 0 0 0 0 0 0 0 206 86 86 86 86 86 208 698 698 820 0 0 206 86 86 86 86 
0 0 0 0 0 206 86 208 0 0 818 698 166 167 167 167 167 167 167 167 167 167 167 128 86 86 86 86 86 208 698 698 820 0 0 206 86 86 86 86 
0 0 0 0 0 206 86 208 0 0 818 698 206 86 86 86 86 86 86 86 86 86 86 86 86 86 86 86 86 208 698 698 820 0 0 206 86 86 86 86 
0 0 0 0 0 206 86 208 0 0 818 698 206 86 86 86 86 86 86 86 86 86 86 86 86 86 86 86 86 208 698 698 820 0 0 206 86 86 86 86 
0 0 0 0 0 206 86 208 0 0 818 698 206 86 86 86 86 86 86 86 86 86 86 86 86 86 86 86 86 208 698 698 820 0 0 206 86 86 86 86 
13
23 7 2 7 4 0 0 320 240
31 7 2 7 4 0 0 320 240
39 7 2 5 4 0 0 320 240
19 2 2 7 4 0 0 320 240
27 2 2 7 4 0 0 320 240
35 2 2 7 4 0 0 320 240
35 16 2 8 4 0 0 320 240
34 11 2 8 4 0 0 320 240
8 19 2 7 4 0 0 320 240
15 19 2 5 4 0 0 320 240
12 24 2 7 4 0 0 320 240
19 24 2 5 4 0 0 320 240
30 11 2 6 4 0 0 320 240
