504 504 504 504 504 504 504 504 504 504 504 504 504 504 504 504 504 626 683 683 683 683 624 504 504 504 504 504 504 504 504 504 504 504 504 504 504 504 504 504 
504 504 504 504 504 504 504 504 504 504 504 504 504 504 504 504 504 626 683 683 683 683 664 506 504 504 504 504 504 504 504 504 504 504 504 504 504 504 504 504 
504 504 504 504 504 504 504 504 504 504 504 504 504 504 504 504 504 626 683 683 683 683 683 624 504 504 504 504 504 504 504 504 504 504 504 504 504 504 504 504 
504 504 504 504 504 504 504 504 504 504 504 504 504 504 504 504 504 626 844 844 844 844 844 624 504 504 504 504 504 504 504 504 504 504 504 504 504 504 504 504 
504 504 504 504 504 504 504 504 504 504 504 504 504 504 504 504 504 626 0 0 0 0 0 664 506 504 504 504 504 504 504 504 504 504 504 504 504 504 504 504 
504 504 504 504 504 504 504 504 504 504 504 504 504 504 504 504 504 626 0 0 0 0 0 0 624 504 504 504 504 504 504 504 504 504 504 504 504 504 504 504 
665 665 665 665 665 665 665 665 665 665 665 665 665 665 665 506 504 626 0 0 0 0 0 0 624 504 504 504 504 504 504 504 504 504 504 504 504 504 504 504 
9 9 9 9 9 9 9 9 9 9 9 9 9 9 9 624 504 626 0 0 0 0 0 0 664 506 504 504 504 504 504 504 504 504 504 504 504 504 504 504 
0 0 0 0 0 0 0 0 0 0 0 0 0 0 0 624 504 626 0 0 0 0 0 0 0 624 504 504 504 504 504 504 504 504 504 504 504 504 504 504 
0 0 0 0 0 0 0 0 0 0 0 0 0 0 0 624 504 626 0 0 0 0 0 0 0 624 504 504 504 504 504 504 504 504 504 504 504 504 504 504 
0 0 0 0 0 0 0 0 0 0 0 0 0 0 0 624 504 626 0 0 0 0 0 0 0 664 506 504 504 504 504 504 504 504 504 504 504 504 504 504 
0 0 0 0 0 0 0 0 0 0 0 0 0 0 0 624 504 626 0 0 0 0 0 0 0 0 624 504 504 504 504 504 504 504 504 504 504 504 504 504 
0 0 0 0 0 0 0 0 0 0 0 0 0 0 0 624 504 626 0 0 0 0 0 0 0 0 624 504 504 504 504 504 504 504 504 504 504 504 504 504 
0 0 0 0 0 0 0 0 0 0 0 0 0 0 0 624 504 626 0 0 0 0 0 0 0 0 664 506 504 504 504 504 504 504 504 504 504 504 504 504 
0 0 0 0 0 0 0 0 0 0 0 0 0 0 0 624 504 626 0 0 0 0 0 0 0 0 0 624 504 504 504 504 504 504 504 504 504 504 504 504 
0 0 0 0 0 0 0 0 0 0 0 0 0 0 0 624 504 626 0 0 0 0 0 0 0 0 0 624 504 504 504 504 504 504 504 504 504 504 504 504 
0 0 0 0 0 0 0 0 0 0 0 0 0 0 0 624 504 626 0 0 0 0 0 0 0 0 0 664 506 504 504 504 504 504 504 504 504 504 504 504 
0 0 0 0 0 0 0 763 764 764 764 764 764 764 764 624 504 626 764 764 764 764 764 764 764 765 0 0 624 504 504 504 504 504 504 504 504 504 504 504 
0 0 0 0 0 0 0 803 683 683 683 683 683 683 683 624 504 626 683 683 683 683 683 683 683 805 0 0 624 504 504 504 504 504 504 504 504 504 504 504 
0 0 0 0 0 0 0 803 683 683 683 683 683 683 683 624 504 626 683 683 683 683 683 683 683 805 0 0 664 506 504 504 504 504 504 504 504 504 504 504 
0 0 0 0 0 0 0 803 683 683 683 683 683 683 683 624 504 626 683 683 683 683 683 683 683 805 0 0 0 624 504 504 504 504 504 504 504 504 504 504 
0 0 0 0 0 0 0 803 683 683 683 683 683 683 683 624 504 626 683 683 683 683 683 683 683 805 0 0 0 624 504 504 504 504 504 504 504 504 504 504 
0 0 0 0 0 0 0 803 683 683 683 683 683 683 683 624 504 626 683 683 683 683 683 683 683 805 0 0 0 664 506 504 504 504 504 504 504 504 504 504 
0 0 0 0 0 0 0 803 683 683 683 683 683 683 683 624 504 626 683 683 683 683 683 683 683 805 0 0 0 0 624 504 504 504 504 504 504 504 504 504 
0 0 0 0 0 0 0 803 683 683 683 683 683 683 683 624 504 626 683 683 683 683 683 683 683 805 0 0 0 0 624 504 504 504 504 504 504 504 504 504 
0 0 0 0 0 0 0 803 683 683 683 683 683 683 683 624 504 626 683 683 683 683 683 683 683 805 0 0 0 0 664 506 504 504 504 504 504 504 504 504 
0 0 0 0 0 0 0 803 683 683 683 683 683 683 683 624 504 626 683 683 683 683 683 683 683 805 0 0 0 0 0 624 504 504 504 504 504 504 504 504 
0 0 0 0 0 0 0 803 683 683 683 683 683 683 683 624 504 626 683 683 683 683 683 683 683 805 0 0 0 0 0 624 504 504 504 504 504 504 504 504 
0 0 0 0 0 0 0 803 683 683 683 683 683 683 683 624 504 626 683 683 683 683 683 683 683 805 0 0 0 0 0 624 504 504 504 504 504 504 504 504 
1
5 9 2 4 0 0 0 320 240
