283 283 283 283 283 283 283 283 283 283 283 283 283 283 283 283 283 283 283 283 283 283 283 283 283 283 283 283 283 283 283 283 283 283 283 283 283 283 283 283 
283 283 283 283 283 283 283 283 283 283 283 283 283 283 283 283 283 283 283 283 283 283 283 283 283 283 283 283 283 283 283 283 283 283 283 283 283 283 283 283 
283 283 283 283 283 283 283 283 284 444 444 444 444 444 444 444 444 444 285 283 284 444 444 444 444 444 444 444 444 444 444 444 444 285 283 283 283 283 283 283 
283 283 283 283 283 283 283 283 405 0 0 0 0 0 0 0 0 0 403 283 405 0 0 0 0 0 0 0 0 0 0 0 0 403 283 283 283 283 283 283 
283 283 283 283 283 283 283 283 405 0 0 0 0 0 0 0 0 0 403 283 405 0 0 0 0 0 0 0 0 0 0 0 0 403 283 283 283 283 283 283 
283 283 283 283 283 283 283 283 405 0 0 0 0 0 0 0 0 0 403 283 405 0 0 0 0 0 0 0 0 0 0 0 0 403 283 283 283 283 283 283 
283 283 283 283 283 283 283 283 405 0 0 0 0 0 0 0 0 0 403 283 405 0 0 0 0 0 0 0 0 0 0 0 0 403 283 283 283 283 283 283 
283 283 283 283 283 283 283 283 405 0 0 0 363 364 365 0 0 0 403 283 405 0 0 0 363 364 365 0 0 0 0 0 0 403 283 283 283 283 283 283 
283 283 283 283 283 283 283 283 405 0 0 0 403 283 405 0 0 0 443 444 445 0 0 0 403 283 405 0 0 0 0 0 0 403 283 283 283 283 283 283 
283 283 283 283 283 283 283 283 405 0 0 0 403 283 405 0 0 0 0 0 0 0 0 0 403 283 405 0 0 0 0 0 0 403 283 283 283 283 283 283 
444 444 444 444 444 444 285 283 405 0 0 0 403 283 405 0 0 0 0 0 0 0 0 0 403 283 405 0 0 0 0 0 0 403 283 283 283 283 283 283 
0 0 0 0 0 0 403 283 405 0 0 0 403 283 405 0 0 0 0 0 0 0 0 0 403 283 405 0 0 0 0 0 0 403 283 283 283 283 283 283 
0 0 0 0 0 0 403 283 405 0 0 0 403 283 405 0 0 0 0 0 0 0 0 0 403 283 405 0 0 0 0 0 0 403 283 283 283 283 283 283 
0 0 0 0 0 0 403 283 405 0 0 0 403 283 324 364 364 364 364 364 364 364 364 364 325 283 405 0 0 0 0 0 0 403 283 283 283 283 283 283 
0 0 0 0 0 0 403 283 405 0 0 0 403 283 283 283 283 283 283 283 283 283 283 283 283 283 405 0 0 0 0 0 0 403 283 283 283 283 283 283 
0 0 0 0 0 0 403 283 405 0 0 0 443 444 444 444 444 444 444 444 444 444 444 444 285 283 405 0 0 0 0 0 0 403 283 283 283 283 283 283 
0 0 0 0 0 0 403 283 405 0 0 0 0 0 0 0 0 0 0 0 0 0 0 0 403 283 405 0 0 0 0 0 0 403 283 283 283 283 283 283 
364 364 365 0 0 0 403 283 405 0 0 0 0 0 0 0 0 0 0 0 0 0 0 0 403 283 405 0 0 0 0 0 0 403 283 283 283 283 283 283 
283 283 405 0 0 0 403 283 405 0 0 0 0 0 0 0 0 0 0 0 0 0 0 0 403 283 405 0 0 0 0 0 0 403 283 283 283 283 283 283 
283 283 405 0 0 0 403 283 405 0 0 0 0 0 0 0 0 0 0 0 0 0 0 0 403 283 405 0 0 0 0 0 0 403 283 283 283 283 283 283 
283 283 405 0 0 0 403 283 324 364 364 364 364 364 364 364 364 364 364 364 365 0 0 0 403 283 405 0 0 0 0 0 0 403 283 283 283 283 283 283 
283 283 405 0 0 0 403 283 283 283 283 283 283 283 283 283 283 283 283 283 405 0 0 0 403 283 405 0 0 0 0 0 0 403 283 283 283 283 283 283 
283 283 405 0 0 0 443 444 444 444 444 444 444 444 444 444 444 444 444 444 445 0 0 0 403 283 405 0 0 0 0 0 0 403 283 283 283 283 283 283 
283 283 405 0 0 0 0 0 0 0 0 0 0 0 0 0 0 0 0 0 0 0 0 0 403 283 405 0 0 0 0 0 0 403 283 283 283 283 283 283 
283 283 405 0 0 0 0 0 0 0 0 0 0 0 0 0 0 0 0 0 0 0 0 0 403 283 405 0 0 0 0 0 0 403 283 283 283 283 283 283 
283 283 405 0 0 0 0 0 0 0 0 0 0 0 0 0 0 0 0 0 0 0 0 0 403 283 405 0 0 0 0 0 0 403 283 283 283 283 283 283 
283 283 405 0 0 0 0 0 0 0 0 0 0 0 0 0 0 0 0 0 0 0 0 0 403 283 405 0 0 0 0 0 0 403 283 283 283 283 283 283 
283 283 324 364 364 364 364 364 364 364 364 364 364 364 364 364 364 364 364 364 364 364 364 364 325 283 405 0 0 0 0 0 0 403 283 283 283 283 283 283 
283 283 283 283 283 283 283 283 283 283 283 283 283 283 283 283 283 283 283 283 283 283 283 283 283 283 405 0 0 0 0 0 0 403 283 283 283 283 283 283 
1
29 3 10 0
