286 286 286 286 286 286 286 286 286 286 286 286 286 286 286 286 286 286 286 286 286 286 286 286 286 286 286 408 0 0 0 0 0 0 0 406 286 286 286 286 
286 287 447 447 447 447 447 447 447 447 288 286 286 287 447 447 447 447 447 447 447 447 288 286 286 287 447 448 0 0 0 0 0 0 0 406 286 286 286 286 
286 408 68 68 68 68 68 68 68 68 406 286 286 408 68 68 68 68 68 68 68 68 406 286 286 408 68 68 0 0 0 0 0 0 0 406 286 286 286 286 
286 408 0 0 0 0 0 0 0 0 406 286 286 408 0 0 0 0 0 0 0 0 406 286 286 408 0 0 0 0 0 0 0 0 0 406 286 286 286 286 
286 408 0 0 0 0 0 0 0 0 406 286 286 408 0 0 0 0 0 0 0 0 406 286 286 408 0 0 0 0 0 0 0 0 0 406 286 286 286 286 
286 408 0 0 0 0 0 0 0 0 406 286 286 408 0 0 0 0 0 0 0 0 406 286 286 408 0 0 0 0 0 0 0 0 0 406 286 286 286 286 
286 408 0 0 0 0 0 0 0 0 406 286 286 408 0 0 0 0 0 0 0 0 406 286 286 408 0 0 0 0 0 0 0 0 0 406 286 286 286 286 
286 408 0 0 0 0 0 0 0 0 406 286 286 408 0 0 0 0 0 0 0 0 406 286 286 408 0 0 0 0 0 0 0 0 0 406 286 286 286 286 
286 408 0 0 0 0 0 0 0 0 406 286 286 408 0 0 0 0 0 0 0 0 406 286 286 408 0 0 0 0 0 0 0 0 0 406 286 286 286 286 
447 448 0 0 0 0 0 0 0 0 446 447 447 448 0 0 0 0 0 0 0 0 446 447 447 448 0 0 0 0 0 0 0 0 0 406 286 286 286 286 
0 0 0 0 0 0 0 0 0 0 68 68 68 68 0 0 0 0 0 0 0 0 68 68 68 68 0 0 0 0 0 0 0 0 0 406 286 286 286 286 
0 0 0 0 0 0 0 0 0 0 0 0 0 0 0 0 0 0 0 0 0 0 0 0 0 0 0 0 0 0 0 0 0 0 0 406 286 286 286 286 
0 0 0 0 0 0 0 0 0 0 0 0 0 0 0 0 0 0 0 0 0 0 0 0 0 0 0 0 0 0 0 0 0 0 0 406 286 286 286 286 
0 0 0 0 0 0 0 0 0 0 0 0 0 0 0 0 0 0 0 0 0 0 0 0 0 0 0 0 0 0 0 0 0 0 0 406 286 286 286 286 
0 0 0 0 0 0 0 0 0 0 0 0 0 0 0 0 0 0 0 0 0 0 0 0 0 0 0 0 0 0 0 0 0 0 0 406 286 286 286 286 
0 0 0 0 0 0 0 0 0 0 0 0 0 0 0 0 0 0 0 0 0 0 0 0 0 0 0 0 0 0 0 0 0 0 0 406 286 286 286 286 
0 0 0 0 0 0 0 0 0 0 0 0 0 0 0 0 0 0 0 0 0 0 0 0 0 0 0 0 0 0 0 0 0 0 0 406 286 286 286 286 
0 0 0 0 0 0 0 0 0 0 0 0 0 0 0 0 0 0 0 0 0 0 0 0 0 0 0 0 0 0 0 0 0 0 0 406 286 286 286 286 
0 0 0 0 0 0 0 0 0 0 0 0 0 0 0 0 67 67 67 67 0 0 0 0 0 0 0 0 0 0 0 0 0 0 0 406 286 286 286 286 
367 367 367 367 367 367 367 368 0 0 0 0 0 0 0 0 366 367 367 368 0 0 0 0 0 0 0 0 366 367 367 367 367 367 367 328 286 286 286 286 
286 286 286 286 286 286 286 408 0 0 0 0 0 0 0 0 406 286 286 408 0 0 0 0 0 0 0 0 406 286 286 286 286 286 286 286 286 286 286 286 
286 286 286 286 286 286 286 408 0 0 0 0 0 0 0 0 406 286 286 408 0 0 0 0 0 0 0 0 406 286 286 286 286 286 286 286 286 286 286 286 
286 286 286 286 286 286 286 408 0 0 0 0 0 0 0 0 406 286 286 408 0 0 0 0 0 0 0 0 406 286 286 286 286 286 286 286 286 286 286 286 
286 286 286 286 286 286 286 408 0 0 0 0 0 0 0 0 406 286 286 408 0 0 0 0 0 0 0 0 406 286 286 286 286 286 286 286 286 286 286 286 
286 286 286 286 286 286 286 408 0 0 0 0 0 0 0 0 406 286 286 408 0 0 0 0 0 0 0 0 406 286 286 286 286 286 286 286 286 286 286 286 
286 286 286 286 286 286 286 408 0 0 0 0 0 0 0 0 406 286 286 408 0 0 0 0 0 0 0 0 406 286 286 286 286 286 286 286 286 286 286 286 
286 286 286 286 286 286 286 408 67 67 67 67 67 67 67 67 406 286 286 408 67 67 67 67 67 67 67 67 406 286 286 286 286 286 286 286 286 286 286 286 
286 286 286 286 286 286 286 327 367 367 367 367 367 367 367 367 328 286 286 327 367 367 367 367 367 367 367 367 328 286 286 286 286 286 286 286 286 286 286 286 
286 286 286 286 286 286 286 286 286 286 286 286 286 286 286 286 286 286 286 286 286 286 286 286 286 286 286 286 286 286 286 286 286 286 286 286 286 286 286 286 
5
31 17 10 1
2 8 11 64
14 8 11 64
8 20 11 64
20 20 11 64
