289 289 289 289 289 289 289 289 289 289 289 289 289 289 289 289 289 289 289 289 289 289 289 289 289 289 289 289 289 289 289 289 289 289 289 289 289 289 289 289 
289 289 289 289 289 289 289 289 289 289 289 289 289 289 289 289 289 289 289 289 289 289 289 289 289 289 289 289 289 289 289 289 289 289 289 289 289 289 289 289 
289 289 289 290 450 450 450 450 450 450 450 450 450 291 289 289 289 290 450 450 450 450 450 450 450 450 450 450 450 450 450 450 450 291 289 289 289 289 289 289 
289 289 289 411 0 0 0 0 0 0 0 0 0 409 289 289 289 411 0 0 0 0 0 0 0 0 0 0 0 0 0 0 0 409 289 289 289 289 289 289 
289 289 289 411 0 0 0 0 0 0 0 0 0 409 289 289 289 411 0 0 0 0 0 0 0 0 0 0 0 0 0 0 0 409 289 289 289 289 289 289 
289 289 289 411 0 0 0 0 0 0 0 0 369 331 289 289 289 330 371 0 0 0 0 0 0 0 0 0 0 0 0 0 0 409 289 289 289 289 289 289 
289 289 289 411 0 0 0 0 0 0 0 0 449 450 450 450 450 450 451 0 0 0 0 0 0 0 0 0 0 0 0 0 0 409 289 289 289 289 289 289 
289 289 289 411 0 0 0 0 0 0 0 0 0 0 0 0 0 0 0 0 0 0 0 0 0 0 0 0 0 0 0 0 0 409 289 289 289 289 289 289 
289 289 289 411 0 0 0 0 0 0 0 0 0 0 0 0 0 0 0 0 0 0 0 0 0 0 0 0 0 0 0 0 0 409 289 289 289 289 289 289 
289 289 289 411 0 0 0 0 0 0 0 0 0 0 0 0 0 0 0 0 0 0 0 0 0 0 0 0 0 0 0 0 0 409 289 289 289 289 289 289 
289 289 289 411 0 0 0 0 0 0 0 0 0 0 0 0 0 0 0 0 0 0 0 0 0 0 0 0 0 0 0 0 0 409 289 289 289 289 289 289 
289 289 289 411 0 0 0 369 371 0 0 0 0 0 0 0 0 0 0 0 0 0 0 0 0 0 0 0 0 0 0 0 0 409 289 289 289 289 289 289 
289 289 289 330 370 370 370 331 411 0 0 0 0 0 0 0 0 0 0 0 0 0 0 0 0 0 0 0 0 0 0 0 0 409 289 289 289 289 289 289 
289 289 289 289 289 289 289 289 411 0 0 0 0 0 0 0 0 0 0 0 0 0 0 0 0 0 0 0 0 0 0 0 0 409 289 289 289 289 289 289 
289 289 289 289 289 289 289 289 411 0 0 0 0 0 0 0 0 0 0 0 0 0 0 0 0 0 0 0 0 0 0 0 0 409 289 289 289 289 289 289 
289 289 289 289 289 289 289 289 411 0 0 0 0 0 0 0 0 0 0 0 0 0 0 0 0 0 0 0 0 0 0 0 0 409 289 289 289 289 289 289 
289 289 289 290 450 450 450 291 411 0 0 0 0 0 0 0 0 0 0 0 0 0 0 0 0 0 0 0 0 0 0 0 0 409 289 289 289 289 289 289 
289 289 289 411 0 0 0 449 451 0 0 0 0 0 0 0 0 0 0 0 0 0 0 0 0 0 0 0 0 0 0 0 0 409 289 289 289 289 289 289 
289 289 289 411 0 0 0 0 0 0 0 0 0 0 0 0 0 0 0 0 0 0 0 0 0 0 0 0 0 0 0 0 0 409 289 289 289 289 289 289 
289 289 289 411 0 0 0 0 0 0 0 0 0 0 0 0 0 0 0 0 0 0 0 0 0 0 0 0 0 0 0 0 0 449 450 450 450 450 450 450 
289 289 289 411 0 0 0 0 0 0 0 0 369 370 370 370 370 370 371 0 0 0 0 0 0 0 0 0 0 0 0 0 0 0 0 0 0 0 0 0 
289 289 289 411 0 0 0 0 0 0 0 0 449 291 289 289 289 290 451 0 0 0 0 0 0 0 0 0 0 0 0 0 0 0 0 0 0 0 0 0 
289 289 289 411 0 0 0 0 0 0 0 0 0 409 289 289 289 411 0 0 0 0 0 0 0 0 0 0 0 0 0 0 0 0 0 0 0 0 0 0 
289 289 289 411 0 0 0 0 0 0 0 0 0 409 289 289 289 411 0 0 0 0 0 0 0 0 0 0 0 0 0 0 0 0 0 0 0 0 0 0 
289 289 289 411 0 0 0 0 0 0 0 0 0 409 289 289 289 411 0 0 0 0 0 0 0 0 0 0 0 0 0 0 0 0 0 0 0 0 0 0 
289 289 289 330 370 370 370 370 370 370 370 370 370 331 289 289 289 330 370 370 370 370 370 370 370 370 370 370 370 370 370 370 370 370 370 370 370 370 370 370 
289 289 289 289 289 289 289 289 289 289 289 289 289 289 289 289 289 289 289 289 289 289 289 289 289 289 289 289 289 289 289 289 289 289 289 289 289 289 289 289 
289 289 289 289 289 289 289 289 289 289 289 289 289 289 289 289 289 289 289 289 289 289 289 289 289 289 289 289 289 289 289 289 289 289 289 289 289 289 289 289 
289 289 289 289 289 289 289 289 289 289 289 289 289 289 289 289 289 289 289 289 289 289 289 289 289 289 289 289 289 289 289 289 289 289 289 289 289 289 289 289 
0
