280 402 51 0 0 0 0 0 0 0 0 0 0 0 0 0 0 52 400 280 280 280 280 280 280 280 280 280 280 280 280 280 280 280 280 280 280 280 280 280 
280 402 51 0 0 0 0 0 0 0 0 0 0 0 0 0 0 52 400 280 280 280 280 280 280 280 280 280 280 281 441 441 441 441 441 441 441 441 441 441 
280 402 51 0 0 0 0 0 0 0 0 0 0 0 0 0 0 52 400 280 280 280 280 280 280 280 280 280 281 442 64 64 64 64 64 64 64 64 64 64 
280 402 51 0 0 0 0 0 0 0 0 0 0 0 0 0 0 52 400 280 280 280 280 281 441 441 441 441 442 51 0 0 0 0 0 0 0 0 0 0 
280 402 51 0 0 0 0 0 0 0 0 0 0 0 0 0 0 52 400 280 280 280 281 442 0 0 0 0 0 0 0 0 0 0 0 0 0 0 0 0 
280 402 51 0 0 0 0 0 0 0 0 0 0 0 0 0 0 52 400 280 280 280 402 51 0 0 0 0 0 0 0 0 0 0 0 0 0 0 0 0 
280 402 51 0 0 0 0 0 0 0 0 0 0 0 0 0 0 52 400 280 280 280 402 51 0 0 0 0 0 0 0 0 0 0 0 0 0 0 0 0 
280 402 51 0 0 0 0 0 0 0 0 0 0 0 0 0 0 52 400 280 280 280 402 51 0 0 0 0 0 0 0 0 0 0 0 0 0 0 0 0 
280 402 51 0 0 0 0 0 0 0 0 0 0 0 0 0 0 52 400 280 280 280 402 51 0 0 0 0 0 0 0 0 0 0 0 0 0 0 0 0 
280 402 51 0 0 0 0 0 0 0 0 0 0 0 0 0 0 52 400 280 280 280 402 51 0 0 0 0 0 0 0 0 0 0 0 0 0 0 0 0 
280 402 51 0 0 0 0 0 0 0 0 0 0 0 0 0 0 52 440 282 280 281 442 51 0 0 0 0 0 0 0 0 0 0 0 0 0 0 0 0 
280 402 51 0 0 0 0 0 0 0 0 0 0 0 0 0 0 0 64 440 344 442 64 0 0 0 0 0 0 0 0 0 0 0 0 0 0 0 0 0 
280 402 51 0 0 0 0 0 0 0 0 0 0 0 0 0 0 0 0 64 464 64 0 0 0 0 0 0 0 0 0 0 0 0 0 0 0 0 0 0 
280 402 51 0 0 0 0 0 0 0 0 0 0 0 0 0 0 0 0 0 64 0 0 0 0 0 0 0 0 0 0 0 0 0 0 0 0 0 0 0 
280 402 51 0 0 0 0 0 0 0 0 0 0 0 0 0 0 0 0 0 0 0 0 0 0 0 0 0 0 0 0 0 360 361 361 361 361 361 361 361 
280 402 51 0 0 0 0 0 0 0 0 0 0 0 0 0 0 0 0 0 0 0 0 0 0 0 0 0 0 0 0 0 400 280 280 280 280 280 280 280 
280 402 51 0 0 0 0 0 0 0 0 0 0 0 0 0 0 0 0 0 0 0 0 0 0 0 0 0 0 0 0 0 400 280 280 280 280 280 280 280 
280 402 51 0 0 0 0 0 0 0 0 0 0 0 0 0 0 0 0 0 0 0 0 0 0 0 0 0 0 0 0 52 400 280 280 280 280 280 280 280 
280 402 51 0 0 0 0 0 0 0 0 0 0 0 0 0 0 0 0 0 0 0 0 0 0 0 0 0 0 0 0 52 400 280 280 280 280 280 280 280 
280 402 51 0 0 0 0 0 0 0 0 0 0 0 0 0 0 0 0 0 0 0 0 0 0 0 0 0 0 0 0 52 400 280 280 280 280 280 280 280 
280 402 51 0 0 0 0 0 0 0 0 0 0 0 0 0 0 0 0 0 0 0 0 0 0 0 0 0 0 0 0 52 400 280 280 280 280 280 280 280 
280 402 51 0 0 0 0 0 0 0 0 0 0 0 0 0 0 0 0 0 0 0 0 0 0 0 0 0 0 0 0 52 400 280 280 280 280 280 280 280 
280 402 51 0 0 0 0 0 0 0 0 0 0 0 0 0 0 0 0 0 0 0 0 0 0 0 0 0 0 0 0 52 400 280 280 280 280 280 280 280 
280 402 51 0 0 0 0 0 0 0 0 0 0 0 0 0 0 0 0 0 0 0 0 0 0 0 0 0 0 0 0 52 400 280 280 280 280 280 280 280 
280 402 51 0 0 0 0 0 0 0 0 0 0 0 0 0 0 0 0 0 0 0 0 0 0 0 0 0 0 0 0 52 400 280 280 280 280 280 280 280 
280 402 51 0 0 0 0 0 0 0 0 0 0 0 0 0 0 0 0 0 0 0 0 0 0 0 0 0 0 0 0 52 400 280 280 280 280 280 280 280 
280 402 51 0 0 0 0 0 0 0 0 0 0 0 0 0 0 0 0 0 0 0 0 0 0 0 0 0 0 0 0 52 400 280 280 280 280 280 280 280 
280 321 362 63 63 63 63 63 63 63 63 63 63 63 63 63 63 63 63 63 63 63 63 63 63 63 63 63 63 63 63 360 322 280 280 280 280 280 280 280 
280 280 321 361 361 361 361 361 361 361 361 361 361 361 361 361 361 361 361 361 361 361 361 361 361 361 361 361 361 361 361 322 280 280 280 280 280 280 280 280 
3
3 23 11 224
35 12 10 1
25 4 10 0
