295 295 295 295 295 417 0 415 295 295 295 295 295 295 295 295 295 417 0 0 0 0 0 415 295 295 295 295 295 295 295 295 295 295 295 295 295 295 295 295 
295 295 295 295 295 417 0 415 295 295 295 295 295 295 295 295 295 417 0 0 0 0 0 415 295 295 295 295 295 295 295 295 295 295 295 295 295 295 295 295 
295 295 295 295 295 417 0 415 295 295 295 295 295 295 295 295 295 417 0 0 0 0 0 415 295 295 295 295 295 295 295 295 295 295 295 295 295 295 295 295 
295 295 295 295 295 417 0 415 295 295 296 456 456 456 456 456 456 457 0 0 0 0 0 455 456 456 456 456 456 456 456 456 456 456 456 297 295 295 295 295 
295 295 295 295 295 417 0 415 295 295 417 0 0 0 0 0 0 0 0 0 0 0 0 0 0 0 0 0 0 0 0 0 0 0 0 415 295 295 295 295 
295 295 295 295 295 417 0 415 295 295 417 0 375 376 376 376 376 377 0 0 0 0 0 375 376 376 376 376 376 376 376 376 376 377 0 415 295 295 295 295 
295 295 295 295 295 417 0 415 295 295 417 0 415 295 295 295 295 417 0 0 0 0 0 415 295 295 295 295 295 295 295 295 295 417 0 415 295 295 295 295 
295 295 295 295 295 417 0 415 295 295 417 0 415 295 296 456 456 457 0 0 0 0 0 455 456 456 456 456 456 456 456 297 295 417 0 415 295 295 295 295 
295 295 295 295 295 417 0 415 295 295 417 0 415 295 417 0 0 0 0 0 0 0 0 0 0 0 0 0 0 0 0 415 295 417 0 415 295 295 295 295 
295 295 295 295 295 417 0 415 295 295 417 0 415 295 417 0 375 377 0 0 0 0 0 375 376 376 376 376 376 377 0 415 295 417 0 415 295 295 295 295 
295 295 295 295 295 417 0 415 295 295 417 0 415 295 417 0 415 417 0 0 0 0 0 455 456 456 456 456 297 417 0 415 295 417 0 415 295 295 295 295 
295 295 295 295 295 417 0 415 295 295 417 0 415 295 417 0 415 417 0 0 0 0 0 0 0 0 0 0 415 417 0 415 295 417 0 415 295 295 295 295 
295 295 295 295 295 417 0 415 295 295 417 0 415 295 417 0 415 417 0 0 0 0 0 375 376 376 377 0 415 417 0 415 295 417 0 415 295 295 295 295 
295 295 295 295 295 417 0 415 295 295 417 0 415 295 417 0 415 417 0 0 0 0 0 455 456 297 417 0 415 417 0 415 295 417 0 415 295 295 295 295 
295 295 295 295 295 417 0 415 295 295 417 0 415 295 417 0 415 417 0 0 0 0 0 0 0 415 417 0 415 417 0 415 295 417 0 415 295 295 295 295 
295 295 295 295 295 417 0 415 295 295 417 0 415 295 417 0 415 417 0 0 0 0 0 396 0 415 417 0 415 417 0 415 295 417 0 415 295 295 295 295 
295 295 295 295 295 417 0 415 295 295 417 0 415 295 417 0 415 417 0 0 0 0 0 476 0 415 417 0 415 417 0 415 295 417 0 415 295 295 295 295 
295 295 295 295 295 417 0 415 295 295 417 0 415 295 417 0 415 417 0 0 0 0 0 0 0 415 417 0 415 417 0 415 295 417 0 415 295 295 295 295 
295 295 295 295 295 417 0 415 295 295 417 0 415 295 417 0 415 417 0 0 0 0 0 375 376 337 417 0 415 417 0 415 295 417 0 415 295 295 295 295 
456 456 456 456 456 457 0 455 456 456 457 0 455 456 457 0 455 457 0 0 0 0 0 455 456 456 457 0 415 417 0 415 295 417 0 415 295 295 295 295 
0 0 0 0 0 0 0 0 0 0 0 0 0 0 0 0 0 0 0 0 0 0 0 0 0 0 0 0 415 417 0 415 295 417 0 415 295 295 295 295 
0 0 0 0 0 0 0 0 0 0 0 0 0 0 0 0 0 0 0 0 0 0 0 375 376 376 376 376 337 417 0 415 295 417 0 415 295 295 295 295 
0 0 0 0 0 0 0 0 0 0 0 0 0 0 0 0 0 0 0 0 0 0 0 455 456 456 456 456 456 457 0 415 295 417 0 415 295 295 295 295 
0 0 0 0 0 0 0 0 0 0 0 0 0 0 0 0 0 0 0 0 0 0 0 0 0 0 0 0 0 0 0 415 295 417 0 415 295 295 295 295 
0 0 0 0 0 0 0 0 0 0 0 0 0 0 0 0 0 0 0 0 0 0 0 375 376 376 376 376 376 376 376 337 295 417 0 415 295 295 295 295 
376 376 376 376 376 377 0 375 376 376 377 0 375 376 376 376 376 376 376 376 376 376 376 337 295 295 295 295 295 295 295 295 295 417 0 415 295 295 295 295 
295 295 295 295 295 417 0 415 295 295 417 0 455 456 456 456 456 456 456 456 456 456 456 456 456 456 456 456 456 456 456 456 456 457 0 415 295 295 295 295 
295 295 295 295 295 417 0 415 295 295 417 0 0 0 0 0 0 0 0 0 0 0 0 0 0 0 0 0 0 0 0 0 0 0 0 415 295 295 295 295 
295 295 295 295 295 417 0 415 295 295 336 376 376 376 376 376 376 376 376 376 376 376 376 376 376 376 376 376 376 376 376 376 376 376 376 337 295 295 295 295 
1
14 23 10 1
