0 0 0 0 0 0 0 0 0 0 0 0 0 0 0 0 0 0 0 0 0 0 0 0 0 0 0 0 0 0 0 0 0 0 0 0 0 0 0 0 
0 0 0 0 0 0 0 0 0 0 0 0 0 0 0 0 0 0 0 0 0 0 0 0 0 0 0 0 0 0 0 0 0 0 0 0 0 0 0 0 
0 0 0 0 0 0 0 0 0 0 0 0 0 0 0 0 0 0 0 0 0 0 0 0 0 0 0 0 0 0 0 0 0 0 0 0 0 0 0 0 
0 0 0 0 0 0 0 0 0 0 0 0 0 0 0 0 0 0 0 0 0 0 0 0 0 0 0 0 0 0 0 0 0 0 0 0 0 0 0 0 
367 367 367 367 367 367 368 0 0 0 0 0 0 0 0 0 0 0 0 0 0 0 0 0 0 0 0 0 0 0 0 0 0 0 0 0 0 0 0 0 
286 286 286 286 286 286 408 0 0 0 0 0 0 0 0 0 0 0 0 0 0 0 0 0 360 361 362 372 373 374 0 0 0 0 0 0 0 0 0 0 
286 286 286 286 286 286 408 0 0 0 0 0 0 0 0 0 0 0 0 0 0 0 0 0 400 280 402 412 292 414 0 0 0 0 0 0 0 0 0 0 
447 447 447 447 288 286 408 0 0 0 0 0 0 0 0 0 0 0 0 0 0 0 0 0 400 280 402 412 292 414 0 0 0 0 0 0 0 0 0 0 
364 364 364 365 406 286 408 0 0 0 0 0 0 0 0 0 0 360 361 362 0 0 0 0 400 280 402 452 453 454 0 0 0 0 366 367 367 368 0 0 
283 283 283 405 406 286 408 0 0 0 0 0 0 0 0 0 0 400 280 402 0 0 0 0 400 280 321 361 361 362 0 0 0 0 406 286 286 408 0 0 
283 283 283 405 406 286 408 0 0 0 0 0 0 0 0 0 0 400 280 402 0 0 0 0 440 441 441 282 280 402 0 0 0 0 406 286 286 408 0 0 
283 283 283 405 406 286 408 0 0 0 0 369 370 371 360 361 361 322 280 402 0 0 0 0 0 0 0 400 280 402 0 0 0 0 406 286 286 408 0 0 
283 283 283 405 406 286 408 0 0 0 0 409 289 411 400 280 280 280 280 402 0 0 0 0 0 0 0 400 280 402 0 0 0 0 406 286 286 408 0 0 
283 283 283 405 446 447 448 0 0 0 0 409 289 411 440 441 441 441 441 442 0 0 0 0 0 0 0 440 441 442 0 0 0 0 406 286 286 408 0 0 
283 283 283 324 364 364 365 0 0 0 0 409 289 411 0 0 0 0 0 0 0 0 0 0 0 0 0 0 0 0 0 0 0 0 406 286 286 408 0 0 
283 283 283 283 283 283 405 0 0 0 0 409 289 411 0 0 0 0 0 0 0 0 0 0 0 0 0 0 0 0 0 0 0 0 406 286 286 408 0 0 
283 283 283 283 283 283 405 0 0 0 0 409 289 411 0 0 0 0 0 0 0 0 0 0 363 364 364 364 364 365 0 0 0 0 406 287 447 448 0 0 
283 283 283 283 283 283 405 0 0 0 0 409 289 411 0 0 0 0 0 0 0 0 0 0 443 444 285 283 283 405 0 0 0 0 406 408 375 377 0 0 
444 444 444 444 444 444 445 0 0 0 0 409 289 411 0 0 0 369 370 370 370 370 370 370 370 371 403 284 444 445 0 0 0 0 406 408 415 417 0 0 
373 373 373 373 373 373 374 0 0 0 0 409 289 411 0 0 0 409 289 290 450 450 450 450 450 451 403 405 0 0 0 0 0 0 406 408 415 417 0 0 
292 292 292 292 292 292 414 375 376 376 377 409 289 411 0 0 0 409 289 411 363 364 364 364 364 364 325 405 0 0 0 0 0 0 406 408 415 417 0 0 
292 292 292 293 453 453 454 415 295 295 417 409 289 411 0 0 0 449 450 451 443 444 444 444 444 444 444 445 0 0 0 0 0 0 446 448 415 336 376 376 
292 292 292 414 360 361 362 415 295 295 417 409 289 411 0 0 0 0 0 0 0 0 0 0 0 0 0 0 0 0 0 375 376 376 376 376 337 295 295 295 
292 292 292 414 400 280 402 415 295 295 417 409 289 411 0 0 0 0 0 0 0 0 0 0 0 0 0 0 0 0 0 415 295 295 295 295 295 295 295 295 
292 292 292 414 400 280 402 455 456 456 457 409 289 411 0 0 0 0 0 0 0 0 0 0 0 0 0 0 0 0 0 415 295 295 295 295 295 295 295 295 
292 292 292 414 400 280 321 361 361 361 362 409 289 330 370 370 370 370 370 370 370 370 370 370 371 375 376 376 376 376 376 337 295 295 295 295 295 295 295 295 
292 292 292 414 400 280 280 280 280 280 402 409 289 289 289 289 289 289 289 290 450 450 450 450 451 415 295 295 295 295 295 295 295 295 295 295 295 295 295 295 
292 292 292 414 400 280 280 280 280 280 402 409 289 289 289 289 289 289 289 411 375 376 376 376 376 337 295 295 295 295 295 295 295 295 295 295 295 295 295 295 
292 292 292 414 400 280 280 280 280 280 402 409 289 289 289 289 289 289 289 411 415 295 295 295 295 295 295 295 295 295 295 295 295 295 295 295 295 295 295 295 
0
