444 444 444 444 444 444 444 444 444 285 283 283 283 284 444 444 444 444 444 444 444 444 444 444 444 444 285 283 283 283 284 444 444 444 444 444 444 444 444 444 
66 66 66 66 66 66 66 66 66 443 285 283 284 445 66 66 66 66 66 66 66 66 66 66 66 66 443 285 283 284 445 66 66 66 66 66 66 66 66 66 
0 0 0 0 0 0 0 0 0 54 403 283 405 53 0 0 0 0 0 0 0 0 0 0 0 0 54 403 283 405 53 0 0 0 0 0 0 0 0 0 
0 0 0 0 0 0 0 0 0 54 403 283 405 53 0 0 0 0 0 0 0 0 0 0 0 0 54 403 283 405 53 0 0 0 0 0 0 0 0 0 
0 0 0 0 0 0 0 0 0 54 403 283 405 53 0 0 0 0 0 0 0 0 0 0 0 0 54 403 283 405 53 0 0 0 0 0 0 0 0 0 
0 0 0 0 0 0 0 0 0 54 443 359 445 53 0 0 0 0 0 0 0 0 0 0 0 0 54 403 283 405 53 0 0 0 0 0 0 0 0 0 
0 0 0 0 0 0 0 0 0 0 66 473 66 0 0 0 0 0 0 0 0 0 0 0 0 0 54 403 283 405 53 0 0 0 0 0 0 0 0 0 
0 0 0 0 0 0 0 0 0 0 0 66 0 0 0 0 0 0 0 0 0 0 0 0 0 0 54 403 283 405 53 0 0 0 0 0 0 0 0 0 
0 0 0 0 0 0 0 0 0 0 0 0 0 0 0 0 0 0 0 0 0 0 0 0 0 0 54 403 283 405 53 0 0 0 0 0 0 0 0 0 
0 0 0 0 0 0 0 0 0 0 0 0 0 0 0 0 0 0 0 0 0 0 0 0 0 0 54 403 283 405 53 0 0 0 0 0 0 0 0 0 
0 0 0 0 0 0 0 0 0 0 0 0 0 0 0 0 0 0 0 0 0 0 0 0 0 0 54 403 283 405 53 0 0 0 0 0 0 0 0 0 
0 0 0 0 0 0 0 0 0 0 0 0 0 0 0 0 0 0 0 0 0 0 0 0 0 0 54 403 283 405 53 0 0 0 0 0 0 0 0 0 
0 0 0 0 0 0 0 0 0 0 0 0 0 0 0 0 0 0 0 0 0 0 0 0 0 0 54 403 283 405 53 0 0 0 0 0 0 0 0 0 
0 0 0 0 0 0 0 0 0 0 0 0 0 0 0 0 0 0 0 0 0 0 0 0 0 0 54 403 283 405 53 0 0 0 0 0 0 0 0 0 
0 0 0 0 0 0 0 0 0 0 0 0 0 0 0 0 0 0 0 0 0 0 0 0 0 0 54 403 283 405 53 0 0 0 0 0 0 0 0 0 
0 0 0 0 0 0 0 0 0 0 0 0 0 0 0 0 0 0 0 0 0 0 0 0 0 0 54 403 283 405 53 0 0 0 0 0 0 0 0 0 
0 0 0 0 0 0 0 0 0 0 0 0 0 0 0 0 0 0 0 0 0 0 0 0 0 0 54 403 283 405 53 0 0 0 0 0 0 0 0 0 
0 0 0 0 0 0 0 0 0 0 0 0 0 0 0 0 0 0 0 0 0 0 0 0 0 0 54 403 283 405 53 0 0 0 0 0 0 0 0 0 
0 0 0 0 0 0 0 0 0 0 0 0 0 0 0 0 0 0 0 0 0 0 0 0 0 0 54 403 283 405 53 0 0 0 0 0 0 0 0 0 
0 0 0 0 0 0 0 0 0 0 0 0 0 0 0 0 0 0 0 0 0 0 0 0 0 0 54 403 283 405 53 0 0 0 0 0 0 0 0 0 
0 0 0 0 0 0 0 0 0 0 0 0 0 0 0 0 0 0 0 0 0 0 0 0 0 0 54 403 283 405 53 0 0 0 0 0 0 0 0 0 
0 0 0 0 0 0 0 0 0 0 0 0 0 0 0 0 0 0 0 0 0 0 0 0 0 0 54 403 283 405 53 0 0 0 0 0 0 0 0 0 
0 0 0 0 0 0 0 0 0 0 0 0 0 0 0 0 0 0 0 0 0 0 0 0 0 0 54 403 283 405 53 0 0 0 0 0 0 0 0 0 
0 0 0 0 0 0 0 0 0 0 0 0 0 0 0 0 0 0 0 0 0 0 0 0 0 0 54 403 283 405 53 0 0 0 0 0 0 0 0 0 
0 0 0 0 0 0 0 0 0 0 0 65 0 0 0 0 0 0 0 0 0 0 0 0 0 0 54 403 283 405 53 0 0 0 0 0 0 0 0 0 
0 0 0 0 0 0 0 0 0 0 65 393 65 0 0 0 0 0 0 0 0 0 0 0 0 0 54 403 283 405 53 0 0 0 0 0 0 0 0 0 
0 0 0 0 0 0 0 0 0 54 363 353 365 53 0 0 0 0 0 0 0 0 0 0 0 0 54 403 283 405 53 0 0 0 0 0 0 0 0 0 
0 0 0 0 0 0 0 0 0 54 403 283 405 53 0 0 0 0 0 0 0 0 0 0 0 0 54 403 283 405 53 0 0 0 0 0 0 0 0 0 
0 0 0 0 0 0 0 0 0 54 403 283 405 53 0 0 0 0 0 0 0 0 0 0 0 0 54 403 283 405 53 0 0 0 0 0 0 0 0 0 
3
0 3 11 72
14 3 11 96
31 3 11 80
