292 292 292 292 292 292 292 292 292 292 292 292 292 292 292 292 292 292 292 292 292 292 292 292 292 292 292 292 292 414 0 0 0 0 0 0 412 292 292 292 
292 292 292 292 292 292 292 292 292 292 292 292 292 292 292 292 292 292 292 292 292 292 292 292 292 292 292 292 292 414 0 0 0 0 0 0 412 292 292 292 
292 292 292 292 292 292 292 292 292 292 292 292 292 292 292 292 292 292 292 292 292 292 292 292 292 292 292 292 292 414 0 0 0 0 0 0 412 292 292 292 
292 292 292 292 292 292 292 292 292 292 292 292 292 292 292 292 292 292 292 292 292 292 292 292 292 292 292 292 292 414 0 0 0 0 0 0 412 292 292 292 
292 292 292 292 292 292 292 292 292 292 292 292 292 292 292 292 292 292 292 292 292 292 292 292 292 292 292 292 292 414 0 0 0 0 0 0 412 292 292 292 
292 292 292 292 292 292 292 292 292 292 292 292 292 292 292 292 292 292 292 292 292 292 292 292 292 292 292 292 292 414 0 0 0 0 0 0 412 292 292 292 
292 292 293 453 453 453 453 453 453 453 453 453 453 453 453 453 453 453 453 453 453 453 453 453 453 453 453 294 292 414 0 0 0 0 0 0 412 292 292 292 
292 292 414 0 0 0 0 0 0 0 0 0 0 0 0 0 0 0 0 0 0 0 0 0 0 0 0 412 292 414 0 0 0 0 0 0 412 292 292 292 
292 292 414 0 0 0 0 0 0 0 0 0 0 0 0 0 0 0 0 0 0 0 0 0 0 0 0 412 292 414 0 0 0 0 0 0 412 292 292 292 
292 292 414 0 0 0 0 0 0 0 0 0 0 0 0 0 0 0 0 0 0 0 0 0 0 0 0 412 292 414 0 0 0 0 0 0 412 292 292 292 
292 292 414 0 0 0 0 0 0 0 0 0 0 0 0 0 0 0 0 0 0 0 0 0 0 0 0 412 292 414 0 0 0 0 0 0 412 292 292 292 
292 292 333 373 373 373 373 373 373 373 373 373 373 373 373 373 373 374 0 0 0 0 0 0 0 0 0 412 292 414 0 0 0 0 0 0 412 292 292 292 
292 292 292 292 292 292 292 292 292 292 292 292 292 292 292 292 292 414 0 0 0 0 0 0 0 0 0 412 292 414 0 0 0 0 0 0 412 292 292 292 
292 292 292 292 292 292 292 292 292 292 292 292 292 292 292 292 292 414 0 0 0 0 0 0 0 0 0 412 292 414 0 0 0 0 0 0 412 292 292 292 
292 292 292 292 292 292 292 292 292 292 292 292 292 292 292 292 292 414 0 0 0 0 0 0 0 0 0 412 292 414 0 0 0 0 0 0 412 292 292 292 
292 292 292 292 292 292 292 292 292 292 292 292 292 292 292 292 292 414 59 0 0 0 0 0 0 0 60 412 292 414 0 0 0 0 0 0 412 292 292 292 
292 292 292 292 292 292 292 292 292 292 292 292 292 292 292 292 292 414 59 0 0 0 0 0 0 0 60 412 292 414 0 0 0 0 0 0 412 292 292 292 
292 292 292 292 292 292 292 292 292 292 292 292 292 292 292 292 292 414 59 0 0 0 0 0 0 0 60 412 292 414 0 0 0 0 0 0 412 292 292 292 
292 292 292 292 292 292 292 292 292 292 292 292 292 292 292 292 292 414 59 0 0 0 0 0 0 0 60 412 292 414 0 0 0 0 0 0 412 292 292 292 
292 292 292 292 292 292 292 292 292 292 292 292 292 292 292 292 292 414 59 0 0 0 0 0 0 0 60 412 292 414 0 0 0 0 0 0 412 292 292 292 
292 292 292 292 292 292 292 292 292 292 292 292 292 292 292 292 292 414 59 0 0 0 0 0 0 0 60 412 292 414 0 0 0 0 0 0 412 292 292 292 
292 292 292 292 292 292 292 292 292 292 292 292 292 292 292 292 292 414 59 0 0 0 0 0 0 0 60 412 292 414 0 0 0 0 0 0 412 292 292 292 
292 292 292 292 292 292 292 292 292 292 292 292 292 292 292 292 292 414 59 0 0 0 0 0 0 0 60 412 292 414 0 0 0 0 0 0 412 292 292 292 
292 292 292 292 292 292 292 292 292 292 292 292 292 292 292 292 292 414 59 0 0 0 0 0 0 0 60 412 292 414 0 0 0 0 0 0 412 292 292 292 
292 292 292 292 292 292 292 292 292 292 292 292 292 292 292 292 292 414 59 0 0 0 0 0 0 0 60 412 292 414 0 0 0 0 0 0 412 292 292 292 
292 292 292 292 292 292 292 292 292 292 292 292 292 292 292 292 292 414 59 0 0 0 0 0 0 0 60 412 292 414 0 0 0 0 0 0 412 292 292 292 
292 292 292 292 292 292 292 292 292 292 292 292 292 292 292 292 292 414 59 0 0 0 0 0 0 0 60 412 292 414 0 0 0 0 0 0 412 292 292 292 
292 292 292 292 292 292 292 292 292 292 292 292 292 292 292 292 292 414 59 0 0 0 0 0 0 0 60 412 292 414 0 0 0 0 0 0 412 292 292 292 
292 292 292 292 292 292 292 292 292 292 292 292 292 292 292 292 292 414 59 0 0 0 0 0 0 0 60 412 292 414 0 0 0 0 0 0 412 292 292 292 
2
4 8 9
15 9 10 1
