295 295 295 295 295 295 295 295 295 295 295 295 295 295 295 295 295 295 295 295 295 295 295 295 295 295 295 295 295 295 295 295 295 295 295 295 295 295 295 295 
295 296 456 456 456 456 456 456 456 456 456 456 297 295 295 295 295 295 295 295 295 295 295 295 295 295 295 295 295 295 295 295 295 295 295 295 295 295 295 295 
295 417 0 0 0 0 0 0 0 0 0 62 415 295 295 295 295 295 295 295 295 295 295 295 295 295 295 295 295 295 295 295 295 295 295 295 295 295 295 295 
295 417 0 0 0 0 0 0 0 0 0 62 415 295 295 295 295 295 295 295 295 295 295 295 295 295 295 295 295 295 295 295 295 295 295 295 295 295 295 295 
456 457 0 0 0 0 0 0 0 0 0 62 455 456 456 456 456 456 456 456 456 456 456 456 456 297 296 456 456 456 456 456 456 456 456 456 456 456 297 295 
0 0 0 0 375 376 377 61 0 0 0 0 0 0 0 0 0 0 0 0 0 0 0 0 0 415 417 61 0 0 0 0 0 0 0 0 0 62 415 295 
0 0 0 0 415 295 417 61 0 0 0 0 0 0 0 0 0 0 0 0 0 0 0 0 0 415 417 61 0 0 0 0 0 0 0 0 0 62 415 295 
0 0 0 0 415 295 417 61 0 0 0 0 0 0 0 0 0 0 0 0 0 0 0 0 0 415 417 61 0 0 0 0 0 0 0 0 0 62 415 295 
0 0 0 0 415 295 417 61 0 0 0 0 0 0 0 0 0 0 0 0 0 0 0 0 0 415 417 61 0 0 0 0 0 0 0 0 0 62 415 295 
376 376 376 376 337 295 417 61 0 0 0 0 0 0 0 0 0 0 0 0 0 0 0 0 0 415 417 61 0 0 0 0 0 0 0 0 0 62 415 295 
295 295 295 295 295 295 417 61 0 0 0 0 0 0 0 0 0 0 0 0 0 0 0 0 0 415 417 61 0 0 0 0 0 0 0 0 0 62 415 295 
295 295 295 295 295 295 417 61 0 0 0 0 0 0 0 0 0 0 0 0 0 0 0 0 0 415 417 61 0 0 0 0 0 0 0 0 0 62 415 295 
295 295 295 295 295 295 417 61 0 0 0 0 0 0 0 0 0 0 0 0 0 0 0 0 0 455 457 61 0 0 0 0 0 0 0 0 0 62 415 295 
295 295 295 295 295 295 417 61 0 0 0 0 0 0 0 0 0 0 0 0 0 0 0 0 0 0 0 0 0 0 0 0 0 0 0 0 0 62 415 295 
295 295 295 295 295 295 417 61 0 0 0 0 0 0 0 0 0 0 0 0 0 0 0 0 0 0 0 0 0 0 0 0 0 0 0 0 0 62 415 295 
295 295 295 295 295 295 417 61 0 0 0 0 0 0 0 0 0 0 0 0 0 0 0 0 0 0 0 0 0 0 0 0 0 0 0 0 0 62 415 295 
295 295 295 295 295 295 417 61 0 0 0 0 0 0 0 0 0 0 0 0 0 0 0 0 0 0 0 0 0 0 0 0 0 0 0 0 0 62 415 295 
295 295 295 295 295 295 417 61 0 0 0 0 0 0 0 0 0 0 0 0 0 0 0 0 0 0 0 0 0 0 0 0 0 0 0 0 0 62 415 295 
295 295 295 295 295 295 417 61 0 0 0 0 0 0 0 0 0 0 0 0 0 0 0 0 0 0 0 0 0 0 0 0 0 0 0 0 0 62 415 295 
295 295 295 295 295 295 417 61 0 0 0 0 0 0 0 0 0 0 0 0 0 0 0 0 0 0 0 0 0 0 0 0 0 0 0 0 0 62 415 295 
295 295 295 295 295 295 336 376 376 376 376 376 376 376 376 376 376 376 376 376 376 376 376 376 376 376 376 376 376 377 0 0 0 0 0 0 0 62 415 295 
295 295 295 295 295 295 296 456 456 456 456 456 456 456 456 456 456 456 456 456 456 456 456 456 456 456 456 456 456 457 0 0 0 0 0 0 0 62 415 295 
295 295 295 295 295 295 417 0 0 0 0 0 0 0 0 0 0 0 0 0 0 0 0 0 0 0 0 0 0 0 0 0 0 0 0 0 0 62 415 295 
295 295 295 295 295 295 417 0 0 0 0 0 0 0 0 0 0 0 0 0 0 0 0 0 0 0 0 0 0 0 0 0 0 0 0 0 0 62 415 295 
295 295 295 295 295 295 417 0 0 0 0 0 0 0 0 0 0 0 0 0 0 0 0 0 0 0 0 0 0 0 0 0 0 0 0 0 0 62 415 295 
295 295 295 295 295 295 417 0 0 0 0 0 0 0 0 0 0 0 0 0 0 0 0 0 0 0 0 0 0 0 0 0 0 0 0 0 0 62 415 295 
295 295 295 295 295 295 417 0 0 0 0 0 0 0 0 0 0 0 0 0 0 0 0 0 0 0 0 0 0 0 0 0 0 0 0 0 0 62 415 295 
295 295 295 295 295 295 417 0 0 0 0 0 0 0 0 0 0 0 0 0 0 0 0 0 0 0 0 0 0 0 0 0 0 0 0 0 0 62 415 295 
295 295 295 295 295 295 417 0 0 0 0 0 0 0 0 0 0 0 0 0 0 0 0 0 0 0 0 0 0 0 0 0 0 0 0 0 0 62 415 295 
2
20 22 10 0
28 8 11 72
