113 113 113 113 113 113 113 113 113 113 113 113 113 113 113 113 113 113 113 113 113 113 113 113 113 113 113 113 113 113 113 113 113 113 113 113 113 113 113 113 
113 113 113 113 113 113 113 113 113 113 113 113 113 113 113 113 113 113 113 113 113 113 113 113 113 113 113 113 113 113 113 113 113 113 113 113 113 113 113 113 
113 113 113 114 274 274 274 274 274 274 274 274 274 274 274 274 274 274 274 274 274 274 274 274 274 274 274 274 274 274 115 113 113 113 113 113 113 113 113 113 
113 113 113 235 778 0 0 0 0 0 0 0 0 0 0 0 0 0 0 0 0 0 0 0 0 0 0 0 0 0 233 113 113 113 113 113 113 113 113 113 
113 113 113 235 0 0 0 0 0 0 0 0 0 0 0 0 0 0 0 0 0 0 0 0 0 0 0 0 0 0 233 113 113 113 114 274 274 274 274 274 
113 113 113 235 0 0 0 0 0 0 0 0 0 0 0 0 0 0 0 0 0 0 0 0 0 0 0 0 0 0 233 113 113 113 235 753 753 753 753 753 
113 113 113 235 0 0 0 0 0 0 0 0 0 0 0 0 0 0 0 0 0 0 0 0 0 0 0 0 0 0 233 113 113 113 235 753 753 753 753 753 
113 113 113 154 194 194 194 194 194 194 194 194 194 194 194 194 194 194 194 194 195 0 0 0 0 0 0 0 0 0 273 274 274 274 275 753 753 753 753 753 
113 113 113 114 274 274 274 274 274 274 274 274 274 274 274 274 274 274 274 274 275 0 0 0 0 0 0 0 0 0 0 0 873 753 753 753 753 753 753 753 
113 113 113 235 778 0 0 0 0 0 0 0 0 0 0 0 0 0 0 0 0 0 0 0 0 0 0 0 0 0 0 0 873 753 753 753 753 753 753 753 
113 113 113 235 0 0 0 0 0 0 0 0 0 0 0 0 0 0 0 0 0 0 0 0 0 0 0 0 0 0 0 0 873 753 753 753 753 753 753 753 
113 113 113 235 0 0 0 0 0 0 0 0 0 0 0 0 0 0 0 0 0 0 0 0 0 0 0 0 0 0 0 0 873 753 753 753 753 753 753 753 
113 113 113 235 0 0 0 0 0 0 0 0 0 0 0 0 0 0 0 0 0 0 0 0 0 0 0 0 0 0 0 0 873 753 753 753 753 753 753 753 
113 113 113 154 194 194 194 194 194 194 194 194 194 194 194 194 194 194 194 194 194 194 194 195 0 0 0 0 0 0 0 0 873 753 753 753 753 753 753 753 
113 113 113 114 274 274 274 274 274 274 274 274 274 274 274 274 274 274 274 274 274 274 274 275 0 0 0 0 0 0 0 0 873 753 753 753 753 753 753 753 
113 113 113 235 778 0 0 0 0 0 0 0 0 0 0 0 0 0 0 0 0 0 0 0 0 0 0 0 0 0 0 0 873 753 753 753 753 753 753 753 
113 113 113 235 0 0 0 0 0 0 0 0 0 0 0 0 0 0 0 0 0 0 0 0 0 0 0 0 0 0 0 0 873 753 753 753 753 753 753 753 
113 113 113 235 0 0 0 0 0 0 0 0 0 0 0 0 0 0 0 0 0 0 0 0 0 0 0 0 0 0 0 0 873 753 753 753 753 753 753 753 
113 113 113 235 0 0 0 0 0 0 0 0 0 0 0 0 0 0 0 0 0 0 0 0 0 0 0 0 0 0 0 0 873 753 753 753 753 753 753 753 
113 113 113 154 194 194 194 194 194 194 194 194 194 194 194 194 194 194 194 194 194 194 194 194 194 194 195 0 0 0 0 0 873 753 753 753 753 753 753 753 
113 113 113 114 274 274 274 274 274 274 274 274 274 274 274 274 274 274 274 274 274 274 274 274 274 274 275 0 0 0 0 0 873 753 753 753 753 753 753 753 
113 113 113 235 778 0 0 0 0 0 0 0 0 0 0 0 0 0 0 0 0 0 0 0 0 0 0 0 0 0 0 0 873 753 753 753 753 753 753 753 
113 113 113 235 0 0 0 0 0 0 0 0 0 0 0 0 0 0 0 0 0 0 0 0 0 0 0 0 0 0 0 0 873 753 753 753 753 753 753 753 
113 113 113 235 0 0 0 0 0 0 0 0 0 0 0 0 0 0 0 0 0 0 0 0 0 0 0 0 0 0 0 0 873 753 753 753 753 753 753 753 
113 113 113 235 0 0 0 0 0 0 0 0 0 0 0 0 0 0 0 0 0 0 0 0 0 0 0 0 0 0 0 0 873 753 753 753 753 753 753 753 
113 113 113 154 194 194 194 194 194 194 194 194 194 194 194 194 194 194 194 194 194 194 194 194 194 194 194 194 194 194 194 194 194 194 194 194 194 194 194 194 
113 113 113 113 113 113 113 113 113 113 113 113 113 113 113 113 113 113 113 113 113 113 113 113 113 113 113 113 113 113 113 113 113 113 113 113 113 113 113 113 
113 113 113 113 113 113 113 113 113 113 113 113 113 113 113 113 113 113 113 113 113 113 113 113 113 113 113 113 113 113 113 113 113 113 113 113 113 113 113 113 
113 113 113 113 113 113 113 113 113 113 113 113 113 113 113 113 113 113 113 113 113 113 113 113 113 113 113 113 113 113 113 113 113 113 113 113 113 113 113 113 
113 113 113 113 113 113 113 113 113 113 113 113 113 113 113 113 113 113 113 113 113 113 113 113 113 113 113 113 113 113 113 113 113 113 113 113 113 113 113 113 
20
5 4 9
8 4 9
11 4 9
5 10 9
8 10 9
11 10 9
14 10 9
5 16 9
8 16 9
11 16 9
14 16 9
17 16 9
5 22 9
8 22 9
11 22 9
14 22 9
17 22 9
14 4 9
17 10 9
17 4 9
