495 495 495 495 495 495 495 495 495 617 0 0 0 0 0 0 0 0 0 0 0 0 0 0 0 0 0 0 0 0 0 0 0 615 495 495 495 495 495 495 
495 495 495 495 495 495 495 495 495 617 0 0 0 0 0 0 0 0 0 0 0 0 0 0 0 0 0 0 0 0 0 0 0 615 495 495 495 495 495 495 
495 495 495 495 495 495 495 495 495 617 0 0 0 0 0 0 0 0 0 0 0 0 0 0 0 0 0 0 0 0 0 0 0 615 495 495 495 495 495 495 
495 495 495 495 495 495 495 495 495 536 577 0 0 0 0 0 0 0 0 0 0 0 0 0 0 0 0 0 0 0 0 0 0 615 495 495 495 495 495 495 
495 495 495 495 495 495 495 495 495 495 617 0 0 0 0 0 0 0 0 0 0 0 0 0 0 0 0 0 0 0 0 0 575 537 495 495 495 495 495 495 
495 495 495 495 495 495 495 495 495 495 617 0 0 0 0 0 0 0 0 0 0 0 0 0 0 0 0 0 0 0 0 0 615 495 495 495 495 495 495 495 
495 495 495 495 495 495 495 495 495 495 617 0 0 0 0 0 0 0 0 0 0 0 0 0 0 0 0 0 0 0 0 575 537 495 495 495 495 495 495 495 
495 495 495 495 495 495 495 495 495 495 617 0 0 0 0 0 0 0 0 0 0 0 0 0 0 0 0 0 0 0 0 615 495 495 495 495 495 495 495 495 
495 495 495 495 495 495 495 495 495 495 617 696 696 696 696 696 696 696 696 696 696 696 696 696 696 696 696 696 696 696 696 615 495 495 495 495 495 495 495 495 
495 495 495 495 495 495 495 495 495 495 617 0 0 0 0 0 0 0 0 0 0 0 0 0 0 0 0 0 0 0 0 615 495 495 495 495 495 495 495 495 
495 495 495 495 495 495 495 495 495 495 536 577 0 0 0 0 0 0 0 0 0 0 0 0 0 0 0 0 0 0 0 615 495 495 495 495 495 495 495 495 
495 495 495 495 495 495 495 495 495 495 495 617 0 0 0 0 0 0 0 0 0 0 0 0 0 0 0 0 0 0 0 615 495 495 495 495 495 495 495 495 
495 495 495 495 495 495 495 495 495 495 495 617 0 0 0 0 0 0 0 0 0 0 0 0 0 0 0 0 0 0 0 615 495 495 495 495 495 495 495 495 
495 495 495 495 495 495 495 495 495 495 495 617 0 0 0 0 0 0 0 0 0 0 0 0 0 0 0 0 0 0 0 615 495 495 495 495 495 495 495 495 
495 495 495 495 495 495 495 495 495 495 495 617 0 0 0 0 0 0 0 0 0 0 0 0 0 0 0 0 0 0 0 615 495 495 495 495 495 495 495 495 
495 495 495 495 495 495 495 495 495 495 495 617 0 0 0 0 0 0 0 0 0 0 0 0 0 0 0 0 0 0 0 615 495 495 495 495 495 495 495 495 
495 495 495 495 495 495 495 495 495 495 495 536 577 0 0 0 0 0 0 0 0 0 0 0 0 0 0 0 0 0 0 615 495 495 495 495 495 495 495 495 
495 495 495 495 495 495 495 495 495 495 495 495 617 0 0 0 0 0 0 0 0 0 0 0 0 0 0 0 0 0 0 615 495 495 495 495 495 495 495 495 
495 495 495 495 495 495 495 495 495 495 495 495 617 696 696 696 696 696 696 696 696 696 696 696 696 696 696 696 696 696 696 615 495 495 495 495 495 495 495 495 
495 495 495 495 495 495 495 495 495 495 495 496 657 0 0 0 0 0 0 0 0 0 0 0 0 0 0 0 0 0 0 615 495 495 495 495 495 495 495 495 
495 495 495 495 495 495 495 495 495 495 495 617 0 0 0 0 0 0 0 0 0 0 0 0 0 0 0 0 0 0 0 655 497 495 495 495 495 495 495 495 
495 495 495 495 495 495 495 495 495 495 496 657 0 0 0 0 0 0 0 0 0 0 0 0 0 0 0 0 0 0 0 0 615 495 495 495 495 495 495 495 
495 495 495 495 495 495 495 495 495 496 657 0 0 0 0 0 0 0 0 0 0 0 0 0 0 0 0 0 0 0 0 0 615 495 495 495 495 495 495 495 
495 495 495 495 495 495 495 495 495 617 0 0 0 0 0 0 0 0 0 0 0 0 0 0 0 0 0 0 0 0 0 0 615 495 495 495 495 495 495 495 
495 495 495 495 495 495 495 495 495 617 0 0 0 0 0 0 0 0 0 0 0 0 0 0 0 0 0 0 0 0 0 0 655 497 495 495 495 495 495 495 
495 495 495 495 495 495 495 495 495 617 0 0 0 0 0 0 0 0 0 0 0 0 0 0 0 0 0 0 0 0 0 0 0 615 495 495 495 495 495 495 
495 495 495 495 495 495 495 495 495 617 0 0 0 0 0 0 0 0 0 0 0 0 0 0 0 0 0 0 0 0 0 0 0 615 495 495 495 495 495 495 
495 495 495 495 495 495 495 495 495 617 0 0 0 0 0 0 0 0 0 0 0 0 0 0 0 0 0 0 0 0 0 0 0 615 495 495 495 495 495 495 
495 495 495 495 495 495 495 495 495 617 0 0 0 0 0 0 0 0 0 0 0 0 0 0 0 0 0 0 0 0 0 0 0 615 495 495 495 495 495 495 
495 495 495 495 495 495 495 495 495 617 0 0 0 0 0 0 0 0 0 0 0 0 0 0 0 0 0 0 0 0 0 0 0 615 495 495 495 495 495 495 
0
