483 483 483 483 483 483 483 483 483 483 483 483 483 483 483 483 483 483 483 483 483 483 483 483 483 483 483 483 483 483 483 483 483 483 483 483 483 483 483 483 
644 644 644 644 644 644 644 644 644 644 644 644 644 644 644 644 644 644 644 644 644 644 644 644 485 483 483 483 483 483 483 483 483 483 483 483 483 483 483 483 
0 0 0 0 683 0 0 0 0 0 0 0 683 0 0 0 0 0 0 0 0 0 0 50 603 483 483 483 483 483 483 483 483 483 483 483 483 483 483 483 
0 0 0 0 683 0 0 0 0 0 0 0 683 0 0 0 0 0 0 0 0 0 0 50 603 483 483 483 483 483 483 483 483 483 483 483 483 483 483 483 
0 0 0 0 683 0 0 0 0 0 0 0 683 0 0 0 0 0 0 0 0 0 0 50 603 483 483 483 483 483 483 483 483 483 483 483 483 483 483 483 
0 0 0 0 683 0 0 0 0 0 0 0 683 0 0 0 0 0 0 0 0 0 0 50 603 483 483 483 483 483 483 483 483 483 483 483 483 483 483 483 
564 564 564 564 564 564 564 564 564 564 564 564 564 564 564 564 565 0 0 0 0 0 0 50 603 483 483 483 483 483 483 483 483 483 483 483 483 483 483 483 
483 483 483 483 483 483 483 483 483 483 483 483 483 483 483 483 605 0 0 0 0 0 0 50 603 483 483 483 483 483 483 483 483 483 483 483 483 483 483 483 
483 483 483 483 483 483 483 483 483 483 483 483 483 483 484 644 645 0 0 0 0 0 0 50 603 483 483 483 483 483 483 483 483 483 483 483 483 483 483 483 
483 483 483 483 483 483 483 483 483 483 483 483 483 483 605 49 0 0 0 0 0 0 50 563 525 483 483 483 483 483 483 483 483 483 483 483 483 483 483 483 
483 483 483 483 483 483 483 483 483 483 483 483 483 483 605 49 0 0 0 0 0 0 50 603 483 483 483 483 483 483 483 483 483 483 483 483 483 483 483 483 
483 483 483 483 483 483 483 483 483 483 483 483 483 484 645 49 0 0 0 0 0 0 50 603 483 483 483 483 483 483 483 483 483 483 483 483 483 483 483 483 
483 483 483 483 483 483 483 483 483 483 483 483 483 605 49 0 0 0 0 0 0 50 563 525 483 483 483 483 483 483 483 483 483 483 483 483 483 483 483 483 
483 483 483 483 483 483 483 483 483 483 483 483 483 605 49 0 0 0 0 0 0 50 603 483 483 483 483 483 483 483 483 483 483 483 483 483 483 483 483 483 
483 483 483 483 483 483 483 483 483 483 483 483 484 645 49 0 0 0 0 0 0 50 603 483 483 483 483 483 483 483 483 483 483 483 483 483 483 483 483 483 
483 483 483 483 483 483 483 483 483 483 483 483 605 49 0 0 0 0 0 0 50 563 525 483 483 483 483 483 483 483 483 483 483 483 483 483 483 483 483 483 
483 483 483 483 483 483 483 483 483 483 483 483 605 49 0 0 0 0 0 0 50 603 483 483 483 483 483 483 483 483 483 483 483 483 483 483 483 483 483 483 
483 483 483 483 483 483 483 483 483 483 483 484 645 49 0 0 0 0 0 0 50 603 483 483 483 483 483 483 483 483 483 483 483 483 483 483 483 483 483 483 
483 483 483 483 483 483 483 483 483 483 483 605 49 0 0 0 0 0 0 50 563 525 483 483 483 483 483 483 483 483 483 483 483 483 483 483 483 483 483 483 
483 483 483 483 483 483 483 483 483 483 483 605 49 0 0 0 0 0 0 50 603 483 483 483 483 483 483 483 483 483 483 483 483 483 483 483 483 483 483 483 
483 483 483 483 483 483 483 483 483 483 484 645 49 0 0 0 0 0 0 50 603 483 483 483 483 483 483 483 483 483 483 483 483 483 483 483 483 483 483 483 
483 483 483 483 483 483 483 483 483 483 605 49 0 0 0 0 0 0 50 563 525 483 483 483 483 483 483 483 483 483 483 483 483 483 483 483 483 483 483 483 
483 483 483 483 483 483 483 483 483 483 605 49 0 0 0 0 0 0 50 603 483 483 483 483 483 483 483 483 483 483 483 483 483 483 483 483 483 483 483 483 
483 483 483 483 483 483 483 483 483 484 645 49 0 0 0 0 0 0 50 603 483 483 483 483 483 483 483 483 483 483 483 483 483 483 483 483 483 483 483 483 
483 483 483 483 483 483 483 483 483 605 49 0 0 0 0 0 0 50 563 525 483 483 483 483 483 483 483 483 483 483 483 483 483 483 483 483 483 483 483 483 
483 483 483 483 483 483 483 483 483 605 49 0 0 0 0 0 0 50 603 483 483 483 483 483 483 483 483 483 483 483 483 483 483 483 483 483 483 483 483 483 
483 483 483 483 483 483 483 483 483 605 49 0 0 0 0 0 0 50 603 483 483 483 483 483 483 483 483 483 483 483 483 483 483 483 483 483 483 483 483 483 
483 483 483 483 483 483 483 483 483 605 49 0 0 0 0 0 0 50 603 483 483 483 483 483 483 483 483 483 483 483 483 483 483 483 483 483 483 483 483 483 
483 483 483 483 483 483 483 483 483 605 49 0 0 0 0 0 0 50 603 483 483 483 483 483 483 483 483 483 483 483 483 483 483 483 483 483 483 483 483 483 
483 483 483 483 483 483 483 483 483 605 49 0 0 0 0 0 0 50 603 483 483 483 483 483 483 483 483 483 483 483 483 483 483 483 483 483 483 483 483 483 
1
7 4 10 1
