104 104 104 104 104 104 104 104 104 104 104 104 104 104 104 104 104 104 104 104 104 104 104 104 104 104 104 104 104 104 104 104 104 104 104 104 104 104 104 104 
104 104 104 104 104 104 104 104 104 104 104 104 104 104 104 104 104 104 104 104 104 104 104 104 104 104 104 104 104 104 104 104 104 104 104 104 104 104 104 104 
104 104 104 104 104 104 104 104 104 104 104 104 104 104 104 104 104 104 104 104 104 104 104 104 104 104 104 104 104 104 104 104 104 104 104 104 104 104 104 104 
104 104 104 104 104 104 104 104 104 104 104 104 104 104 104 104 104 104 104 104 104 104 104 104 104 104 104 104 104 104 104 104 104 104 104 104 104 104 104 104 
104 104 104 104 104 104 104 104 104 104 104 104 104 104 104 104 104 104 104 104 104 104 104 104 104 104 104 104 104 104 104 104 104 104 104 104 104 104 104 104 
104 104 104 104 105 265 265 265 265 265 265 265 265 265 265 265 265 265 265 265 265 265 265 265 265 265 265 265 265 265 265 265 265 265 265 265 265 265 265 265 
104 104 104 104 226 744 866 0 0 0 0 0 0 0 0 0 0 0 0 0 0 864 744 744 744 744 744 744 744 744 744 744 744 744 744 744 744 744 744 744 
104 104 104 104 226 744 866 0 0 0 0 0 0 0 0 0 0 0 0 0 0 864 744 744 745 905 746 744 745 905 746 744 745 905 746 744 745 905 746 744 
104 104 104 104 226 744 866 0 0 0 0 0 0 0 0 0 0 0 0 0 0 864 744 744 866 0 864 744 866 0 864 744 866 0 864 744 866 0 864 744 
104 104 104 104 226 744 866 0 0 0 0 0 0 0 0 0 0 0 0 0 0 864 744 744 866 0 864 744 866 0 864 744 866 0 864 744 866 0 864 744 
104 104 104 104 226 744 866 0 0 0 0 0 0 0 0 0 0 0 0 0 0 864 744 744 785 825 786 744 785 825 786 744 785 825 786 744 785 825 786 744 
104 104 104 104 226 744 866 0 0 0 0 0 0 0 0 0 0 0 0 0 0 864 744 744 744 744 744 744 744 744 744 744 744 744 744 744 744 744 744 744 
104 104 104 104 226 744 866 0 0 0 0 0 0 0 0 0 0 0 0 0 0 864 744 744 745 905 905 905 905 905 905 905 905 905 905 905 905 905 746 744 
104 104 104 104 226 744 866 0 0 0 0 0 0 0 0 0 0 0 0 0 0 864 744 744 866 0 0 0 0 0 0 0 0 0 0 0 0 0 864 744 
104 104 104 104 226 744 866 0 0 0 0 0 0 0 0 0 0 0 0 0 0 864 744 744 866 0 0 0 0 0 0 0 0 0 0 0 0 0 864 744 
104 104 104 104 226 744 866 0 0 0 0 0 0 0 0 0 0 0 0 0 0 864 744 744 785 825 825 825 825 825 825 825 825 825 825 825 825 825 786 744 
104 104 104 104 226 744 866 0 0 0 0 0 0 0 0 0 0 0 0 0 0 864 744 744 744 744 744 744 744 744 744 744 744 744 744 744 744 744 744 744 
104 104 104 104 226 744 866 0 0 0 0 0 0 0 0 0 0 0 0 0 0 864 744 744 745 905 746 744 745 905 746 744 745 905 746 744 745 905 746 744 
104 104 104 104 226 744 866 0 0 0 0 0 0 0 0 0 0 0 0 0 0 864 744 744 866 0 864 744 866 0 864 744 866 0 864 744 866 0 864 744 
104 104 104 104 226 744 866 0 0 0 0 0 0 0 0 0 0 0 0 0 0 864 744 744 866 0 864 744 866 0 864 744 866 0 864 744 866 0 864 744 
104 104 104 104 226 744 866 0 0 0 0 0 0 0 0 0 0 0 0 0 0 864 744 744 785 825 786 744 785 825 786 744 785 825 786 744 785 825 786 744 
104 104 104 104 226 744 866 0 0 0 0 0 0 0 0 0 0 0 0 0 0 864 744 744 744 744 744 744 744 744 744 744 744 744 744 744 744 744 744 744 
104 104 104 104 145 185 185 185 185 185 185 185 185 185 185 185 185 185 185 185 185 185 185 185 185 185 185 185 185 185 185 185 185 185 185 186 744 744 744 744 
104 104 104 104 104 104 104 104 104 104 104 104 104 104 104 104 104 104 104 104 104 104 104 104 104 104 104 104 104 104 104 104 104 104 104 226 744 744 744 744 
104 104 104 104 104 104 104 104 104 104 104 104 104 104 104 104 104 104 104 104 104 104 104 104 104 104 104 104 104 104 104 104 104 104 104 226 744 744 744 744 
104 104 104 104 104 104 104 104 104 104 104 104 104 104 104 104 104 104 104 104 104 104 104 104 104 104 104 104 104 104 104 104 104 104 104 145 185 185 185 185 
104 104 104 104 104 104 104 104 104 104 104 104 104 104 104 104 104 104 104 104 104 104 104 104 104 104 104 104 104 104 104 104 104 104 104 104 104 104 104 104 
104 104 104 104 104 104 104 104 104 104 104 104 104 104 104 104 104 104 104 104 104 104 104 104 104 104 104 104 104 104 104 104 104 104 104 104 104 104 104 104 
104 104 104 104 104 104 104 104 104 104 104 104 104 104 104 104 104 104 104 104 104 104 104 104 104 104 104 104 104 104 104 104 104 104 104 104 104 104 104 104 
104 104 104 104 104 104 104 104 104 104 104 104 104 104 104 104 104 104 104 104 104 104 104 104 104 104 104 104 104 104 104 104 104 104 104 104 104 104 104 104 
1
8 8 8
