501 501 501 501 501 501 501 501 501 501 501 501 501 501 501 501 501 501 501 501 501 501 501 501 501 501 501 501 501 501 501 501 623 0 0 0 0 621 501 501 
501 501 501 501 501 501 501 501 501 501 501 501 501 501 501 501 501 501 501 501 501 501 501 501 501 501 501 501 501 501 501 501 623 0 0 0 0 621 501 501 
501 501 501 501 501 501 501 501 501 501 501 501 501 501 501 501 501 501 501 501 501 501 501 501 501 501 501 501 501 501 501 501 623 0 0 0 0 621 501 501 
501 501 501 501 501 501 501 501 501 501 501 501 501 501 501 501 501 501 501 501 501 501 501 501 501 501 501 501 501 501 501 501 623 0 0 0 0 621 501 501 
501 501 501 501 501 501 501 501 501 501 501 501 501 501 501 501 501 501 501 501 501 501 501 501 501 501 501 501 501 501 501 501 623 0 0 0 0 621 501 501 
501 501 501 501 501 501 501 501 501 501 501 501 501 501 501 501 501 501 501 501 501 501 501 501 501 501 501 501 501 501 501 501 623 0 0 0 0 621 501 501 
501 501 501 501 501 501 501 501 501 501 501 501 501 501 501 501 501 501 501 501 501 501 501 501 501 501 501 501 501 501 501 501 623 0 0 0 0 621 501 501 
501 501 501 501 501 501 501 501 501 501 501 501 501 501 501 501 501 501 501 501 501 501 501 501 501 501 501 501 501 501 501 501 623 0 0 0 0 621 501 501 
501 501 501 501 501 501 501 501 501 501 501 501 501 501 501 501 501 501 501 501 501 501 501 501 501 501 501 501 501 501 501 501 623 0 0 0 0 621 501 501 
501 501 501 501 501 501 501 501 501 501 501 501 501 501 501 501 501 501 501 501 501 501 501 502 662 662 662 662 662 662 662 662 663 0 0 0 0 621 501 501 
501 501 501 501 501 501 501 501 501 501 501 501 501 502 662 662 662 662 662 662 662 662 662 663 0 0 0 0 0 0 701 0 0 0 0 0 0 621 501 501 
501 501 501 501 501 501 501 501 501 501 501 501 501 623 0 0 0 0 0 0 0 0 0 0 0 0 0 0 0 0 701 0 0 0 0 0 0 621 501 501 
501 501 501 501 501 501 501 501 501 501 501 501 501 623 0 0 0 0 0 0 0 0 0 0 0 0 0 0 0 0 701 0 0 0 0 0 0 621 501 501 
501 501 501 501 501 501 501 501 501 501 501 501 501 623 0 0 0 0 0 0 0 0 0 0 0 0 0 0 0 0 701 0 0 0 0 0 0 621 501 501 
501 501 501 501 501 501 501 501 501 501 501 501 501 623 0 0 0 0 0 0 0 0 0 0 0 0 0 0 0 0 701 0 0 0 0 0 0 621 501 501 
501 501 501 501 501 501 501 501 501 501 501 501 501 623 0 0 0 0 0 0 0 0 0 0 0 0 0 0 0 0 701 0 0 0 0 0 0 621 501 501 
501 501 501 501 501 501 501 501 501 501 501 501 501 623 0 0 0 0 0 0 0 0 0 0 0 0 0 0 0 0 701 0 0 0 0 0 0 621 501 501 
501 501 501 501 501 501 501 501 501 501 501 501 501 623 0 0 0 0 0 0 0 0 0 0 0 0 0 0 0 0 701 0 0 0 0 0 0 621 501 501 
501 501 501 501 501 501 501 501 501 501 501 501 502 663 0 0 0 0 0 0 0 0 0 581 582 582 582 582 582 582 582 582 582 582 582 582 582 543 501 501 
501 501 501 501 501 501 501 501 501 501 501 501 623 0 0 0 0 0 0 0 0 0 0 621 501 501 501 501 501 501 501 501 501 501 501 501 501 501 501 501 
501 501 501 501 501 501 502 662 662 662 662 662 663 702 702 702 702 702 702 702 702 702 581 543 501 501 501 501 501 501 501 501 501 501 501 501 501 501 501 501 
662 662 662 662 662 662 663 0 0 701 0 0 0 0 0 0 0 0 0 0 0 0 621 501 501 501 501 501 501 501 501 501 501 501 501 501 501 501 501 501 
0 0 0 0 0 0 0 0 0 701 0 0 0 0 0 0 0 0 0 0 0 0 621 501 501 501 501 501 501 501 501 501 501 501 501 501 501 501 501 501 
0 0 0 0 0 0 0 0 0 701 0 0 0 0 0 0 0 0 0 0 0 0 621 501 501 501 501 501 501 501 501 501 501 501 501 501 501 501 501 501 
0 0 0 0 0 0 0 0 0 701 0 0 0 0 0 0 0 0 0 0 0 0 621 501 501 501 501 501 501 501 501 501 501 501 501 501 501 501 501 501 
0 0 0 0 0 0 0 0 0 701 0 0 0 0 0 0 0 0 0 0 0 0 621 501 501 501 501 501 501 501 501 501 501 501 501 501 501 501 501 501 
582 582 582 582 582 582 582 582 582 582 582 582 582 582 582 582 582 582 582 582 582 582 543 501 501 501 501 501 501 501 501 501 501 501 501 501 501 501 501 501 
501 501 501 501 501 501 501 501 501 501 501 501 501 501 501 501 501 501 501 501 501 501 501 501 501 501 501 501 501 501 501 501 501 501 501 501 501 501 501 501 
501 501 501 501 501 501 501 501 501 501 501 501 501 501 501 501 501 501 501 501 501 501 501 501 501 501 501 501 501 501 501 501 501 501 501 501 501 501 501 501 
501 501 501 501 501 501 501 501 501 501 501 501 501 501 501 501 501 501 501 501 501 501 501 501 501 501 501 501 501 501 501 501 501 501 501 501 501 501 501 501 
1
3 24 10 1
