110 110 110 110 110 110 110 110 110 110 110 110 110 110 110 110 110 110 110 110 110 110 110 110 110 110 110 110 110 110 110 110 110 110 110 110 110 110 110 110 
110 110 110 110 110 110 110 110 110 110 110 110 110 110 110 110 110 110 110 110 110 110 110 110 110 110 110 110 110 110 110 110 110 110 110 110 110 110 110 110 
110 110 110 110 110 110 110 110 110 110 110 110 110 110 110 110 110 110 110 110 110 110 110 110 110 110 110 110 110 110 110 110 110 110 110 110 110 110 110 110 
110 110 110 110 110 110 110 110 110 110 110 110 110 110 110 110 110 110 110 110 110 110 110 110 110 110 110 110 110 110 110 110 110 110 110 110 110 110 110 110 
271 271 271 271 271 271 271 271 112 110 110 110 110 110 110 110 110 110 110 110 110 110 110 110 110 110 110 110 110 110 110 110 110 110 110 110 110 110 110 110 
750 750 750 750 750 750 750 750 270 271 271 112 110 110 110 110 110 110 110 110 110 110 110 110 110 110 110 110 110 110 110 110 110 110 110 110 110 110 110 110 
750 750 750 750 750 750 750 750 750 750 750 270 271 271 112 110 110 110 110 110 110 110 110 110 110 110 110 110 110 110 110 110 110 110 110 110 110 110 110 110 
750 751 911 911 911 911 911 911 752 750 750 750 750 750 270 271 271 271 271 271 271 271 271 271 271 271 271 271 112 110 110 110 110 110 110 110 110 110 110 110 
750 872 0 0 0 0 0 0 870 750 750 750 750 750 750 750 750 750 750 750 750 750 750 750 750 750 750 750 270 271 271 271 271 112 110 110 110 110 110 110 
750 872 0 0 0 0 0 0 870 750 750 750 750 750 750 750 750 750 750 750 750 751 911 911 752 750 750 750 750 872 0 0 0 270 271 112 110 110 110 110 
750 872 0 0 0 0 0 0 870 750 750 750 750 750 750 750 750 751 911 911 752 872 0 0 870 750 750 750 750 872 0 0 0 0 0 230 110 110 110 110 
750 791 831 831 831 831 831 831 792 750 750 750 750 751 911 911 752 872 0 0 870 872 0 0 870 750 750 750 750 872 0 0 0 0 0 230 110 110 110 110 
750 750 750 750 750 750 750 750 750 751 911 911 752 872 0 0 870 872 0 0 870 872 0 0 870 750 750 750 750 872 0 0 0 0 0 230 110 110 110 110 
750 750 750 750 750 751 911 911 752 872 0 0 870 872 0 0 870 872 0 0 870 872 0 0 870 750 750 750 750 872 0 0 0 0 0 230 110 110 110 110 
750 751 911 911 752 872 0 0 870 872 0 0 870 872 0 0 870 872 0 0 870 872 0 0 870 750 750 750 750 872 0 0 0 0 0 230 110 110 110 110 
750 872 0 0 870 872 0 0 870 872 0 0 870 872 0 0 870 872 0 0 870 872 0 0 870 750 750 750 750 872 0 0 0 0 0 230 110 110 110 110 
750 872 0 0 870 872 0 0 870 872 0 0 870 872 0 0 870 872 0 0 870 872 0 0 870 750 750 750 750 872 0 0 0 0 0 230 110 110 110 110 
750 872 0 0 870 872 0 0 870 872 0 0 870 872 0 0 870 872 0 0 870 872 0 0 870 750 750 750 190 191 191 191 191 191 191 152 110 110 110 110 
750 872 0 0 870 872 0 0 870 872 0 0 870 872 0 0 870 872 0 0 870 872 0 0 870 750 750 190 152 110 110 110 110 110 110 110 110 110 110 110 
750 872 0 0 870 872 0 0 870 872 0 0 870 872 0 0 870 872 0 0 870 872 0 0 870 750 190 152 110 110 110 110 110 110 110 110 110 110 110 110 
750 872 0 0 870 872 0 0 870 872 0 0 870 872 0 0 870 872 0 0 870 872 0 0 870 750 270 271 271 271 271 271 271 271 271 112 110 110 110 110 
750 872 0 0 870 872 0 0 870 872 0 0 870 872 0 0 870 872 0 0 870 872 0 0 870 750 750 750 750 872 0 0 0 0 0 230 110 110 110 110 
750 872 0 0 870 872 0 0 870 872 0 0 870 872 0 0 870 872 0 0 870 872 0 0 870 750 750 750 750 872 0 0 0 0 0 230 110 110 110 110 
750 791 831 831 792 791 831 831 792 791 831 831 792 791 831 831 792 791 831 831 792 791 831 831 792 750 750 750 750 872 0 0 0 0 0 230 110 110 110 110 
750 750 750 750 750 750 750 750 750 750 750 750 750 750 750 750 750 750 750 750 750 750 750 750 750 750 750 750 750 872 0 0 0 0 0 230 110 110 110 110 
191 191 191 191 191 191 191 191 191 191 191 191 191 191 191 191 191 191 191 191 191 191 191 191 191 191 191 191 191 191 191 191 191 191 191 152 110 110 110 110 
110 110 110 110 110 110 110 110 110 110 110 110 110 110 110 110 110 110 110 110 110 110 110 110 110 110 110 110 110 110 110 110 110 110 110 110 110 110 110 110 
110 110 110 110 110 110 110 110 110 110 110 110 110 110 110 110 110 110 110 110 110 110 110 110 110 110 110 110 110 110 110 110 110 110 110 110 110 110 110 110 
110 110 110 110 110 110 110 110 110 110 110 110 110 110 110 110 110 110 110 110 110 110 110 110 110 110 110 110 110 110 110 110 110 110 110 110 110 110 110 110 
110 110 110 110 110 110 110 110 110 110 110 110 110 110 110 110 110 110 110 110 110 110 110 110 110 110 110 110 110 110 110 110 110 110 110 110 110 110 110 110 
4
32 15 10 1
32 23 10 1
29 23 10 1
26 23 10 1
