489 489 489 489 489 489 489 489 489 489 489 489 489 489 489 489 489 489 489 489 489 489 489 489 489 489 489 489 489 489 489 489 489 489 489 489 489 489 489 489 
489 489 489 489 489 489 489 489 489 489 489 489 489 489 489 489 489 489 489 489 489 489 489 489 489 489 489 489 489 489 489 489 489 489 489 489 489 489 489 489 
489 489 490 650 650 650 650 650 650 650 650 650 650 650 650 650 650 650 650 650 650 650 650 650 650 650 650 650 650 650 650 650 650 650 650 650 650 650 650 650 
489 489 611 0 0 0 0 0 689 0 0 0 0 0 0 0 0 0 689 0 0 0 0 0 0 0 0 0 0 0 0 0 0 0 689 0 0 0 0 0 
489 489 611 0 0 0 0 0 689 0 0 0 0 0 0 0 0 0 689 0 0 0 0 0 0 0 0 0 0 0 0 0 0 0 689 0 0 0 0 0 
489 489 611 0 0 0 0 0 689 0 0 0 0 0 0 0 0 0 689 0 0 0 0 0 0 0 0 0 0 0 0 0 0 0 689 0 0 0 0 0 
489 489 611 0 0 0 0 0 689 0 0 0 0 0 0 0 0 0 689 0 0 0 0 0 0 0 0 0 0 0 0 0 0 0 689 0 0 0 0 0 
489 489 611 0 0 0 0 569 570 570 570 570 570 570 570 570 570 570 570 570 570 570 570 570 570 570 570 570 570 570 570 570 570 570 570 570 570 570 570 570 
489 489 611 690 690 690 690 609 489 489 489 489 489 489 489 489 489 489 489 489 489 489 489 489 489 489 489 489 489 489 489 489 489 489 489 489 489 489 489 489 
489 489 611 0 0 0 0 609 489 489 489 489 489 489 489 489 489 489 489 489 489 489 489 489 489 489 489 489 489 489 489 489 489 489 489 489 489 489 489 489 
489 489 611 0 0 0 0 609 489 489 490 650 650 650 650 650 650 650 650 650 650 650 650 650 650 650 650 650 650 650 650 650 650 650 650 650 650 650 650 650 
489 489 611 0 0 0 0 609 489 489 611 0 0 0 0 0 689 0 0 0 0 0 0 0 0 0 0 0 0 689 0 0 0 0 0 0 0 0 0 0 
489 489 611 0 0 0 0 609 489 489 611 0 0 0 0 0 689 0 0 0 0 0 0 0 0 0 0 0 0 689 0 0 0 0 0 0 0 0 0 0 
489 489 611 0 0 0 0 609 489 489 611 0 0 0 0 0 689 0 0 0 0 0 0 0 0 0 0 0 0 689 0 0 0 0 0 0 0 0 0 0 
489 489 611 0 0 0 0 609 489 489 611 0 0 0 0 0 689 0 0 0 0 0 0 0 0 0 0 0 0 689 0 0 0 0 0 0 0 0 0 0 
489 489 611 0 0 0 0 609 489 489 611 0 0 0 0 569 570 570 570 570 570 570 570 570 570 570 570 570 570 570 570 570 570 570 570 570 570 570 570 570 
489 489 611 0 0 0 0 609 489 489 611 690 690 690 690 609 489 489 489 489 489 489 489 489 489 489 489 489 489 489 489 489 489 489 489 489 489 489 489 489 
489 489 611 0 0 0 0 609 489 489 611 0 0 0 0 609 489 489 489 489 489 489 489 489 489 489 489 489 489 489 489 489 489 489 489 489 489 489 489 489 
489 489 611 0 0 0 0 609 489 489 611 0 0 0 0 609 489 489 490 650 650 650 650 650 650 650 650 650 650 650 650 650 650 650 650 650 650 650 650 650 
489 489 611 0 0 0 0 609 489 489 611 0 0 0 0 609 489 489 611 0 0 0 0 0 689 0 0 0 0 0 0 0 0 0 0 0 0 0 0 0 
489 489 611 0 0 0 0 609 489 489 611 0 0 0 0 609 489 489 611 0 0 0 0 0 689 0 0 0 0 0 0 0 0 0 0 0 0 0 0 0 
489 489 611 0 0 0 0 609 489 489 611 0 0 0 0 609 489 489 611 0 0 0 0 0 689 0 0 0 0 0 0 0 0 0 0 0 0 0 0 0 
489 489 611 690 690 690 690 609 489 489 611 0 0 0 0 609 489 489 611 0 0 0 0 0 689 0 0 0 0 0 0 0 0 0 0 0 0 0 0 0 
489 489 611 0 0 0 0 609 489 489 611 0 0 0 0 609 489 489 611 0 0 0 0 569 570 570 570 570 570 570 570 570 570 570 570 570 570 570 570 570 
489 489 611 0 0 0 0 609 489 489 611 0 0 0 0 609 489 489 611 690 690 690 690 609 489 489 489 489 489 489 489 489 489 489 489 489 489 489 489 489 
489 489 611 0 0 0 0 609 489 489 611 0 0 0 0 609 489 489 611 0 0 0 0 609 489 489 489 489 489 489 489 489 489 489 489 489 489 489 489 489 
489 489 611 0 0 0 0 609 489 489 611 0 0 0 0 609 489 489 611 0 0 0 0 609 489 489 489 489 489 489 489 489 489 489 489 489 489 489 489 489 
489 489 611 0 0 0 0 609 489 489 611 0 0 0 0 609 489 489 611 0 0 0 0 609 489 489 489 489 489 489 489 489 489 489 489 489 489 489 489 489 
489 489 611 0 0 0 0 609 489 489 611 0 0 0 0 609 489 489 611 0 0 0 0 609 489 489 489 489 489 489 489 489 489 489 489 489 489 489 489 489 
489 489 611 0 0 0 0 609 489 489 611 0 0 0 0 609 489 489 611 0 0 0 0 609 489 489 489 489 489 489 489 489 489 489 489 489 489 489 489 489 
2
28 20 9
27 19 8
