486 486 486 486 486 486 486 486 486 486 486 486 486 486 486 486 608 0 0 0 0 606 486 486 608 0 0 0 0 606 486 486 608 0 0 0 0 606 486 486 
486 486 486 486 486 486 486 486 486 486 486 486 486 486 486 486 608 0 0 0 0 606 486 486 608 0 0 0 0 606 486 486 608 0 0 0 0 606 486 486 
486 486 486 486 486 486 486 486 486 486 486 486 486 486 486 486 608 0 0 0 0 606 486 486 608 0 0 0 0 606 486 486 608 0 0 0 0 606 486 486 
486 486 486 486 486 486 486 486 486 486 486 486 486 486 486 486 608 0 0 0 0 606 486 486 608 0 0 0 0 606 486 486 608 0 0 0 0 606 486 486 
486 486 486 486 486 486 486 486 486 486 486 486 486 486 486 486 608 0 0 0 0 606 486 486 608 0 0 0 0 606 486 486 608 0 0 0 0 606 486 486 
486 486 486 486 486 486 486 486 486 486 486 486 486 486 486 486 608 687 687 687 687 606 486 486 608 687 687 687 687 606 486 486 608 687 687 687 687 606 486 486 
647 647 647 647 647 647 647 647 647 647 647 647 647 647 647 647 648 0 0 0 0 606 486 486 608 0 0 0 0 606 486 486 608 0 0 0 0 606 486 486 
0 0 0 686 0 0 0 0 0 686 0 0 0 0 0 686 0 0 0 0 0 606 486 486 608 0 0 0 0 606 486 486 608 0 0 0 0 606 486 486 
0 0 0 686 0 0 0 0 0 686 0 0 0 0 0 686 0 0 0 0 0 606 486 486 608 0 0 0 0 606 486 486 608 0 0 0 0 606 486 486 
0 0 0 686 0 0 0 0 0 686 0 0 0 0 0 686 0 0 0 0 0 606 486 486 608 0 0 0 0 606 486 486 608 0 0 0 0 606 486 486 
0 0 0 686 0 0 0 0 0 686 0 0 0 0 0 686 0 0 0 0 0 606 486 486 608 0 0 0 0 606 486 486 608 0 0 0 0 606 486 486 
567 567 567 567 567 567 567 567 567 567 567 567 567 567 567 567 567 567 567 567 567 528 486 486 608 0 0 0 0 606 486 486 608 0 0 0 0 606 486 486 
486 486 486 486 486 486 486 486 486 486 486 486 486 486 486 486 486 486 486 486 486 486 486 486 608 0 0 0 0 606 486 486 608 0 0 0 0 606 486 486 
486 486 486 486 486 486 486 486 486 486 486 486 486 486 486 486 486 486 486 486 486 486 486 486 608 687 687 687 687 606 486 486 608 687 687 687 687 606 486 486 
647 647 647 647 647 647 647 647 647 647 647 647 647 647 647 647 647 647 647 647 647 647 647 647 648 0 0 0 0 606 486 486 608 0 0 0 0 606 486 486 
0 0 0 686 0 0 0 0 0 686 0 0 0 0 0 686 0 0 0 0 0 0 0 686 0 0 0 0 0 606 486 486 608 0 0 0 0 606 486 486 
0 0 0 686 0 0 0 0 0 686 0 0 0 0 0 686 0 0 0 0 0 0 0 686 0 0 0 0 0 606 486 486 608 0 0 0 0 606 486 486 
0 0 0 686 0 0 0 0 0 686 0 0 0 0 0 686 0 0 0 0 0 0 0 686 0 0 0 0 0 606 486 486 608 0 0 0 0 606 486 486 
0 0 0 686 0 0 0 0 0 686 0 0 0 0 0 686 0 0 0 0 0 0 0 686 0 0 0 0 0 606 486 486 608 0 0 0 0 606 486 486 
567 567 567 567 567 567 567 567 567 567 567 567 567 567 567 567 567 567 567 567 567 567 567 567 568 0 0 0 0 606 486 486 608 0 0 0 0 606 486 486 
486 486 486 486 486 486 486 486 486 486 486 486 486 486 486 486 486 486 486 486 486 486 486 486 608 0 0 0 0 606 486 486 608 0 0 0 0 606 486 486 
486 486 486 486 486 486 486 486 486 486 486 486 486 486 486 486 486 486 486 486 486 486 486 486 608 0 0 0 0 606 486 486 608 687 687 687 687 606 486 486 
647 647 647 647 647 647 647 647 647 647 647 647 647 647 647 647 647 647 647 647 647 647 647 647 648 0 0 0 0 646 647 647 648 0 0 0 0 606 486 486 
0 0 0 686 0 0 0 0 0 686 0 0 0 0 0 686 0 0 0 0 0 0 0 686 0 0 0 0 0 0 0 686 0 0 0 0 0 606 486 486 
0 0 0 686 0 0 0 0 0 686 0 0 0 0 0 686 0 0 0 0 0 0 0 686 0 0 0 0 0 0 0 686 0 0 0 0 0 606 486 486 
0 0 0 686 0 0 0 0 0 686 0 0 0 0 0 686 0 0 0 0 0 0 0 686 0 0 0 0 0 0 0 686 0 0 0 0 0 606 486 486 
0 0 0 686 0 0 0 0 0 686 0 0 0 0 0 686 0 0 0 0 0 0 0 686 0 0 0 0 0 0 0 686 0 0 0 0 0 606 486 486 
567 567 567 567 567 567 567 567 567 567 567 567 567 567 567 567 567 567 567 567 567 567 567 567 567 567 567 567 567 567 567 567 567 567 567 567 567 528 486 486 
486 486 486 486 486 486 486 486 486 486 486 486 486 486 486 486 486 486 486 486 486 486 486 486 486 486 486 486 486 486 486 486 486 486 486 486 486 486 486 486 
486 486 486 486 486 486 486 486 486 486 486 486 486 486 486 486 486 486 486 486 486 486 486 486 486 486 486 486 486 486 486 486 486 486 486 486 486 486 486 486 
0
