495 495 495 495 617 0 0 0 0 0 0 0 0 0 0 0 0 0 0 0 0 0 0 0 0 0 0 0 0 0 0 0 0 0 0 0 0 0 0 0 
495 495 495 495 617 0 0 0 0 0 0 0 0 0 0 0 0 0 0 0 0 0 0 0 0 0 0 0 0 0 0 0 0 0 0 0 0 0 0 0 
495 495 495 495 617 0 0 0 0 0 0 0 0 0 0 0 0 0 0 0 0 0 0 0 0 0 0 0 0 0 0 0 0 0 0 0 0 0 0 0 
495 495 495 495 617 0 0 0 0 0 0 0 0 0 0 0 0 0 0 0 0 0 0 0 0 0 0 0 0 0 0 0 0 0 0 0 0 0 0 0 
495 495 495 495 617 0 0 0 0 0 0 0 0 0 0 0 0 0 0 0 0 0 0 0 0 0 0 0 0 0 0 0 0 0 0 0 0 0 0 0 
495 495 495 495 617 0 0 0 0 0 0 0 0 0 0 0 0 0 0 0 0 0 0 0 0 0 0 0 0 0 0 0 0 0 0 0 0 0 0 0 
495 495 495 495 536 577 0 0 0 0 575 576 576 576 577 0 0 0 0 0 0 0 0 0 0 0 0 0 0 0 0 0 0 0 0 0 0 0 0 0 
495 495 495 495 495 617 696 696 696 696 615 495 495 495 617 0 0 0 0 0 0 0 0 0 0 0 0 0 0 0 0 0 0 0 0 0 0 0 0 0 
495 495 495 495 495 617 0 0 0 0 655 656 656 656 657 0 0 0 0 0 0 0 0 0 0 0 0 0 0 0 0 0 0 0 0 0 0 0 0 0 
495 495 495 495 495 617 0 0 0 0 0 0 0 0 0 0 0 0 0 0 0 0 0 0 0 0 0 0 0 0 0 0 0 0 0 0 0 0 0 0 
495 495 495 495 495 536 577 0 0 0 0 0 0 0 0 0 0 0 0 0 0 0 0 0 0 0 0 0 0 0 0 0 0 0 0 0 0 0 0 0 
495 495 495 495 495 495 617 0 0 0 0 0 0 0 0 0 0 0 0 0 0 0 0 0 0 0 0 0 0 0 0 0 0 0 0 0 0 0 0 0 
495 495 495 495 495 495 536 577 0 0 0 0 0 0 0 0 0 0 0 0 0 0 0 575 576 576 576 577 0 0 0 0 0 0 0 0 0 0 0 0 
495 495 495 495 495 495 495 617 696 696 696 696 696 696 696 696 696 696 696 696 696 696 696 615 495 495 495 617 0 0 0 0 0 0 0 0 0 0 0 0 
495 495 495 495 495 495 495 617 0 0 0 0 0 0 0 0 0 0 0 0 0 0 0 655 656 656 656 657 0 0 0 0 0 0 0 0 0 0 0 0 
495 495 495 495 495 495 495 617 0 0 0 0 0 0 0 0 0 0 0 0 0 0 0 0 0 0 0 0 0 0 0 0 0 0 0 0 0 0 0 0 
495 495 495 495 495 495 495 536 577 0 0 0 0 0 0 0 0 0 0 0 0 0 0 0 0 0 0 0 0 0 0 0 0 0 0 0 0 0 0 0 
495 495 495 495 495 495 495 495 617 0 0 0 0 0 0 0 0 0 0 0 0 0 0 0 0 0 0 0 0 0 0 0 0 0 0 0 0 0 0 0 
495 495 495 495 495 495 495 495 536 577 0 0 0 0 0 575 576 576 576 577 0 0 0 0 0 0 0 0 0 0 0 0 0 0 0 0 0 0 0 0 
495 495 495 495 495 495 495 495 495 617 696 696 696 696 696 615 495 495 495 617 0 0 0 0 0 0 0 0 0 0 0 0 0 0 0 0 0 0 0 0 
495 495 495 495 495 495 495 495 495 617 0 0 0 0 0 655 656 656 656 657 0 0 0 0 0 0 0 0 0 0 0 0 0 0 0 0 0 0 0 0 
495 495 495 495 495 495 495 495 495 617 0 0 0 0 0 0 0 0 0 0 0 0 0 0 0 0 0 0 0 0 0 0 0 0 0 0 0 0 0 0 
495 495 495 495 495 495 495 495 495 617 0 0 0 0 0 0 0 0 0 0 0 0 0 0 0 0 0 0 0 0 0 0 0 0 0 0 0 0 0 0 
495 495 495 495 495 495 495 495 495 617 0 0 0 0 0 0 0 0 0 0 0 0 0 0 0 0 0 0 0 0 0 575 576 576 576 577 0 0 0 0 
495 495 495 495 495 495 495 495 495 617 696 696 696 696 696 696 696 696 696 696 696 696 696 696 696 696 696 696 696 696 696 615 495 495 495 617 0 0 0 0 
495 495 495 495 495 495 495 495 495 617 0 0 0 0 0 0 0 0 0 0 0 0 0 0 0 0 0 0 0 0 0 655 656 656 656 657 0 0 0 0 
495 495 495 495 495 495 495 495 495 617 0 0 0 0 0 0 0 0 0 0 0 0 0 0 0 0 0 0 0 0 0 0 0 0 0 0 0 0 0 0 
495 495 495 495 495 495 495 495 495 617 0 0 0 0 0 0 0 0 0 0 0 0 0 0 0 0 0 0 0 0 0 0 0 0 0 0 0 0 0 0 
495 495 495 495 495 495 495 495 495 617 0 0 0 0 0 0 0 0 0 0 0 0 0 0 0 0 0 0 0 0 0 0 0 0 0 0 0 0 0 0 
495 495 495 495 495 495 495 495 495 617 0 0 0 0 0 0 0 0 0 0 0 0 0 0 0 0 0 0 0 0 0 0 0 0 0 0 0 0 0 0 
0
