283 283 283 283 283 283 283 283 283 283 283 405 695 695 695 695 695 695 695 695 695 695 695 695 695 695 695 695 403 283 283 283 283 283 283 283 283 283 283 283 
283 283 283 283 283 283 283 283 283 283 283 405 695 695 695 695 695 695 695 695 695 695 695 695 695 695 695 695 403 283 283 283 283 283 283 283 283 283 283 283 
283 283 283 283 283 283 283 283 283 283 283 405 695 695 695 695 695 695 695 695 695 695 695 695 695 695 695 695 403 283 283 283 283 283 283 283 283 283 283 283 
283 283 283 283 283 283 283 283 283 283 283 405 695 695 695 695 695 695 695 695 695 695 695 695 695 695 695 695 403 283 283 283 283 283 283 283 283 283 283 283 
283 283 283 283 283 283 283 283 283 283 283 405 695 695 695 695 695 695 695 695 695 695 695 695 695 695 695 695 403 283 283 283 283 283 283 283 283 283 283 283 
283 283 283 283 283 283 283 283 283 283 283 405 695 695 695 695 695 695 695 695 695 695 695 695 695 695 695 695 403 283 283 283 283 283 283 283 283 283 283 283 
283 283 283 283 283 283 283 283 283 283 283 405 695 695 695 695 695 695 695 695 695 695 695 695 695 695 695 695 403 283 283 283 283 283 283 283 283 283 283 283 
283 283 283 283 283 283 283 283 283 283 283 405 695 695 695 695 695 695 695 695 695 695 695 695 695 695 695 695 403 283 283 283 283 283 283 283 283 283 283 283 
283 283 283 283 283 283 283 283 283 283 283 405 695 695 695 695 695 695 695 695 695 695 695 695 695 695 695 695 403 283 283 283 283 283 283 283 283 283 283 283 
283 283 283 283 283 283 283 283 283 283 283 405 695 695 695 695 695 695 695 695 695 695 695 695 695 695 695 695 403 283 283 283 283 283 283 283 283 283 283 283 
283 283 283 283 283 283 283 283 283 283 283 405 695 695 695 695 695 695 695 695 695 695 695 695 695 695 695 695 403 283 283 283 283 283 283 283 283 283 283 283 
283 283 283 283 283 283 283 283 283 283 283 405 695 695 695 695 695 695 695 695 695 695 695 695 695 695 695 695 403 283 283 283 283 283 283 283 283 283 283 283 
283 283 283 283 283 283 283 283 283 283 283 405 695 695 695 695 695 695 695 695 695 695 695 695 695 695 695 695 403 283 283 283 283 283 283 283 283 283 283 283 
283 283 283 283 283 283 283 283 283 283 283 405 695 695 695 695 695 695 695 695 695 695 695 695 695 695 695 695 403 283 283 283 283 283 283 283 283 283 283 283 
283 283 283 283 283 283 283 283 283 283 283 405 695 695 695 695 695 695 695 695 695 695 695 695 695 695 695 695 403 283 283 283 283 283 283 283 283 283 283 283 
283 283 283 283 283 283 283 283 283 283 283 405 695 695 695 695 695 695 695 695 695 695 695 695 695 695 695 695 403 283 283 283 283 283 283 283 283 283 283 283 
283 283 283 283 283 283 283 283 283 283 283 405 695 695 695 695 695 695 695 695 695 695 695 695 695 695 695 695 403 283 283 283 283 283 283 283 283 283 283 283 
283 283 283 283 283 283 283 283 283 283 283 405 695 695 695 695 695 695 695 695 695 695 695 695 695 695 695 695 403 283 283 283 283 283 283 283 283 283 283 283 
283 283 283 283 283 283 283 283 283 283 283 405 695 695 695 695 695 695 695 695 695 695 695 695 695 695 695 695 403 283 283 283 283 283 283 283 283 283 283 283 
283 283 283 283 283 283 283 283 283 283 283 405 695 695 695 695 695 695 695 695 695 695 695 695 695 695 695 695 403 283 283 283 283 283 283 283 283 283 283 283 
283 283 283 283 283 283 283 283 283 283 283 405 695 695 695 695 695 695 695 695 695 695 695 695 695 695 695 695 403 283 283 283 283 283 283 283 283 283 283 283 
283 283 283 283 283 283 283 283 283 283 283 405 695 695 695 695 695 695 695 695 695 695 695 695 695 695 695 695 403 283 283 283 283 283 283 283 283 283 283 283 
283 283 283 283 283 283 283 283 283 283 283 405 695 695 695 695 695 695 695 695 695 695 695 695 695 695 695 695 443 444 444 444 444 444 444 444 444 444 444 444 
283 283 283 283 283 283 283 283 283 283 283 405 695 695 695 695 695 695 695 695 695 695 695 695 695 695 695 695 695 695 695 695 817 0 0 0 0 0 0 0 
283 283 283 283 283 283 283 283 283 283 283 405 695 695 695 695 695 695 695 695 695 695 695 695 695 695 695 695 695 695 695 695 817 0 0 0 0 0 0 0 
283 283 283 283 283 283 283 283 283 283 283 405 695 695 695 695 695 695 695 695 695 695 695 695 695 695 695 695 695 695 695 695 817 0 0 0 0 0 0 0 
283 283 283 283 283 283 283 283 283 283 283 405 695 695 695 695 695 695 695 695 695 695 695 695 695 695 695 695 695 695 695 695 817 0 0 0 0 0 0 0 
283 283 283 283 283 283 283 283 283 283 283 324 364 364 364 364 364 364 364 364 364 364 364 364 364 364 364 364 364 364 364 364 364 364 364 364 364 364 364 364 
283 283 283 283 283 283 283 283 283 283 283 283 283 283 283 283 283 283 283 283 283 283 283 283 283 283 283 283 283 283 283 283 283 283 283 283 283 283 283 283 
283 283 283 283 283 283 283 283 283 283 283 283 283 283 283 283 283 283 283 283 283 283 283 283 283 283 283 283 283 283 283 283 283 283 283 283 283 283 283 283 
1
0 0 10 0
