316 316 438 0 0 403 283 283 283 283 283 283 283 283 283 283 283 283 283 283 283 283 283 283 283 283 283 283 283 283 283 283 283 283 283 283 283 283 283 283 
316 316 438 0 0 403 283 283 283 283 283 283 283 283 283 283 283 283 283 283 283 283 283 283 283 283 283 283 283 283 283 283 283 283 283 283 283 283 283 283 
316 316 438 0 0 403 283 283 283 283 283 283 283 283 283 283 283 283 283 283 283 283 283 283 283 283 283 283 283 283 283 283 283 283 283 283 283 283 283 283 
316 316 438 0 0 403 283 283 283 283 283 283 283 283 283 283 283 283 283 283 283 283 283 283 283 283 283 283 283 283 283 283 283 283 283 283 283 283 283 283 
316 316 438 0 0 403 283 283 283 283 283 283 283 283 283 283 283 283 283 283 283 283 283 283 283 283 283 283 283 283 283 283 283 283 283 283 283 283 283 283 
316 316 438 0 0 403 283 283 283 283 283 283 283 283 283 283 283 283 283 283 283 283 283 283 283 283 283 283 283 283 283 283 283 283 283 283 283 283 283 283 
316 316 438 0 0 403 283 283 283 283 283 283 283 283 283 283 283 283 283 283 283 283 283 283 283 283 283 283 283 283 283 283 283 283 283 283 283 283 283 283 
316 316 438 0 0 403 283 283 283 283 283 283 283 283 283 283 283 283 283 283 283 283 283 283 283 283 283 283 283 283 283 283 283 283 283 283 283 283 283 283 
316 316 438 0 0 403 283 283 283 283 283 283 283 283 283 283 283 283 283 283 283 283 283 283 283 283 283 283 283 283 283 283 283 283 283 283 283 283 283 283 
316 316 438 0 0 403 283 283 283 283 283 283 283 283 283 283 283 283 283 283 283 283 283 283 283 283 283 283 283 283 283 283 283 283 283 283 283 283 283 283 
316 316 438 0 0 443 444 444 444 285 283 283 283 283 283 283 283 283 283 283 283 283 283 283 283 283 283 283 283 283 283 283 283 283 283 283 283 283 283 283 
316 316 438 0 0 0 0 0 0 403 283 284 444 444 444 444 285 283 283 283 283 283 283 283 283 283 283 283 283 283 283 283 283 283 283 283 283 283 283 283 
316 316 438 0 0 0 0 0 0 403 283 405 0 0 0 0 403 283 283 283 283 283 283 283 283 283 283 283 283 283 283 283 283 283 283 283 283 283 283 283 
316 316 438 0 0 0 0 0 0 403 283 405 0 0 0 0 403 283 284 444 444 444 444 285 283 283 283 283 283 283 283 283 283 283 283 283 283 283 283 283 
316 316 438 0 0 0 0 0 0 443 444 445 0 0 0 0 403 283 405 0 0 0 0 403 283 284 444 444 444 444 444 444 444 444 444 444 444 444 444 444 
316 316 438 0 0 0 0 0 0 0 0 0 0 0 0 0 403 283 405 0 0 0 0 403 283 405 0 0 0 0 0 0 0 0 0 0 0 0 0 0 
316 316 438 0 0 0 0 0 0 0 0 0 0 0 0 0 403 283 405 0 0 0 0 403 283 405 0 0 0 0 0 0 0 0 0 0 0 0 0 0 
316 316 438 0 0 0 0 0 0 0 0 0 0 0 0 0 403 283 405 0 0 0 0 403 283 405 0 0 0 0 0 0 0 0 0 0 0 0 0 0 
316 316 357 398 0 0 0 0 0 0 0 0 0 0 0 0 443 444 445 0 0 0 0 403 283 405 0 0 0 0 0 0 0 0 0 0 0 0 0 0 
316 316 316 357 398 0 0 0 0 0 0 0 0 0 0 0 0 0 0 0 0 0 0 403 283 405 0 0 0 0 0 0 0 0 0 0 0 0 0 0 
316 316 316 316 438 0 0 0 0 0 0 0 0 0 0 0 0 0 0 0 0 0 0 403 283 405 0 0 0 0 0 0 0 0 0 0 0 0 0 0 
316 316 316 316 438 0 0 0 0 0 0 0 0 0 0 0 0 0 0 0 0 0 0 403 283 405 0 0 0 0 0 0 0 0 0 0 0 0 0 0 
316 316 316 316 438 0 0 0 0 0 0 0 0 0 0 0 0 0 0 0 0 0 0 443 444 445 0 0 0 0 0 0 0 0 0 0 0 0 0 0 
316 316 316 316 438 0 0 0 0 0 0 0 0 0 0 0 0 0 0 0 0 0 0 0 0 0 0 0 0 0 0 0 0 0 0 0 0 0 0 0 
316 316 316 316 438 0 0 0 0 0 0 0 0 0 0 0 0 0 0 0 0 0 0 0 0 0 0 0 0 0 0 0 0 0 0 0 0 0 0 0 
316 316 316 316 438 0 0 0 0 0 0 0 0 0 0 0 0 0 0 0 0 0 0 0 0 0 0 0 0 0 0 0 0 0 0 0 0 0 0 0 
316 316 316 316 438 0 0 0 0 0 0 0 0 0 0 0 0 0 0 0 0 0 0 0 0 0 0 0 0 0 0 0 0 0 0 0 0 0 0 0 
316 316 316 316 438 0 0 0 0 0 0 0 0 0 0 0 0 0 0 0 0 0 0 0 0 0 0 0 0 0 0 0 0 0 0 0 0 0 0 0 
316 316 316 316 438 0 0 0 0 0 0 0 0 0 0 0 0 0 0 0 0 0 0 0 0 0 0 0 0 0 0 0 0 0 0 0 0 0 0 0 
316 316 316 316 438 0 0 0 0 0 0 0 0 0 0 0 0 0 0 0 0 0 0 0 0 0 0 0 0 0 0 0 0 0 0 0 0 0 0 0 
1
0 0 10 0
