295 295 295 295 295 295 295 295 295 295 295 295 295 295 295 295 295 295 295 295 295 295 295 295 295 295 295 295 295 295 295 295 295 295 295 295 295 295 295 295 
295 295 295 295 295 295 295 295 295 295 295 295 295 295 295 295 295 295 295 295 295 295 295 295 295 295 295 295 295 295 295 295 295 295 295 295 295 295 295 295 
295 295 295 295 295 295 295 295 295 295 295 295 295 295 295 295 295 295 295 295 295 295 295 295 295 295 295 295 295 295 295 295 295 295 295 295 295 295 295 295 
295 295 296 456 456 456 456 456 456 456 456 456 456 297 295 295 295 295 295 295 295 295 295 295 295 295 295 295 295 295 295 295 295 295 295 295 295 295 295 295 
295 295 417 698 698 698 698 698 698 698 698 698 698 415 295 295 295 295 295 295 295 295 295 295 295 295 295 295 295 295 295 295 295 295 295 295 295 295 295 295 
295 295 417 698 698 698 698 698 698 698 698 698 698 415 295 295 296 456 456 456 456 456 456 456 456 456 456 456 297 295 295 295 295 295 295 295 295 295 295 295 
295 295 417 698 698 698 698 698 698 698 698 698 698 415 295 295 417 698 698 698 698 698 698 698 698 698 698 698 415 295 295 295 295 295 295 295 295 295 295 295 
295 295 417 698 698 698 698 698 698 698 698 698 698 415 295 295 417 698 698 698 698 698 698 698 698 698 698 698 415 295 295 295 295 295 295 295 295 295 295 295 
295 295 417 698 698 698 698 375 376 376 376 376 376 337 295 295 417 698 698 698 698 698 698 698 698 698 698 698 415 295 295 295 295 295 295 295 295 295 295 295 
295 295 417 698 698 698 698 415 295 295 295 295 295 295 295 295 417 698 698 698 698 698 698 698 698 698 698 698 415 295 295 295 295 295 295 295 295 295 295 295 
295 295 417 698 698 698 698 415 295 295 295 295 295 295 295 295 417 698 698 698 698 375 376 377 698 698 698 698 415 295 295 295 295 295 295 295 295 295 295 295 
295 295 417 698 698 698 698 455 456 456 456 456 456 456 456 456 457 698 698 698 698 415 295 417 698 698 698 698 415 295 295 295 295 295 295 295 295 295 295 295 
295 295 417 698 698 698 698 698 698 698 698 698 698 698 698 698 698 698 698 698 698 415 295 417 698 698 698 698 415 295 295 295 295 295 295 295 295 295 295 295 
295 295 417 698 698 698 698 698 698 698 698 698 698 698 698 698 698 698 698 698 698 415 295 417 698 698 698 698 415 295 295 295 295 295 295 295 295 295 295 295 
295 295 417 698 698 698 698 698 698 698 698 698 698 698 698 698 698 698 698 698 698 415 295 417 698 698 698 698 415 295 295 295 295 295 295 295 295 295 295 295 
295 295 417 698 698 698 698 698 698 698 698 698 698 698 698 698 698 698 698 698 698 415 295 417 698 698 698 698 415 295 295 295 295 295 295 295 295 295 295 295 
295 295 336 376 376 376 376 376 376 376 376 376 376 376 376 376 376 376 376 376 376 337 295 417 698 698 698 698 415 295 295 295 295 295 295 295 295 295 295 295 
295 295 295 295 295 295 295 295 295 295 295 295 295 295 295 295 295 295 295 295 295 295 295 417 698 698 698 698 415 295 295 295 295 295 295 295 295 295 295 295 
295 295 295 295 295 295 295 295 295 295 295 295 295 295 295 295 295 295 295 295 295 295 295 417 698 698 698 698 415 295 295 295 295 295 295 295 295 295 295 295 
295 295 295 295 295 295 295 295 295 295 295 296 456 456 456 456 456 456 456 456 456 456 456 457 698 698 698 698 415 295 295 295 295 295 295 295 295 295 295 295 
295 295 295 295 295 295 295 295 295 295 295 417 698 698 698 698 698 698 698 698 698 698 698 698 698 698 698 698 415 295 295 295 295 295 295 295 295 295 295 295 
295 295 295 295 295 295 295 295 295 295 295 417 698 698 698 698 698 698 698 698 698 698 698 698 698 698 698 698 415 295 295 295 295 295 295 295 295 295 295 295 
295 295 295 295 295 295 295 295 295 295 295 417 698 698 698 698 698 698 698 698 698 698 698 698 698 698 698 698 415 295 295 295 295 295 295 295 295 295 295 295 
295 295 295 295 295 295 295 295 295 295 295 417 698 698 698 698 698 698 698 698 698 698 698 698 698 698 698 698 415 295 295 295 295 295 295 295 295 295 295 295 
295 295 295 295 295 295 295 295 295 295 295 417 698 698 698 698 698 698 698 698 698 698 698 698 698 698 698 698 415 295 295 295 295 295 295 295 295 295 295 295 
295 295 295 295 295 295 295 295 295 295 295 417 698 698 698 698 698 698 698 698 698 698 698 698 698 698 698 698 415 295 295 295 295 295 295 295 295 295 295 295 
295 295 295 295 295 295 295 295 295 295 295 417 698 698 698 698 698 698 698 698 698 698 698 698 698 698 698 698 415 295 295 295 295 295 295 295 295 295 295 295 
295 295 295 295 295 295 295 295 295 295 295 417 698 698 698 698 698 698 698 698 698 698 698 698 698 698 698 698 415 295 295 295 295 295 295 295 295 295 295 295 
295 295 295 295 295 295 295 295 295 295 295 417 698 698 698 698 698 698 698 698 698 698 698 698 698 698 698 698 415 295 295 295 295 295 295 295 295 295 295 295 
295 295 295 295 295 295 295 295 295 295 295 417 698 698 698 698 698 698 698 698 698 698 698 698 698 698 698 698 415 295 295 295 295 295 295 295 295 295 295 295 
2
10 5 9
0 0 10 0
