0 0 0 0 0 0 0 0 0 0 0 0 0 0 0 0 0 0 0 0 206 86 86 86 86 86 86 86 86 86 86 86 86 86 86 86 86 86 86 86 
0 0 0 0 0 0 0 0 0 0 0 0 0 0 0 0 0 0 0 0 206 86 86 86 86 86 86 86 86 86 86 86 86 86 86 86 86 86 86 86 
0 0 0 0 0 0 0 0 0 0 0 0 0 0 0 0 0 0 0 0 206 86 86 86 86 86 86 86 86 86 86 86 86 86 86 86 86 86 86 86 
0 0 0 0 0 0 0 0 0 0 0 0 0 0 0 0 0 0 0 0 206 86 86 86 86 86 86 86 86 86 86 86 86 86 86 86 86 86 86 86 
0 0 0 0 0 0 0 0 0 0 0 0 0 0 0 0 0 0 0 0 206 86 86 86 86 86 86 86 86 86 86 86 86 86 86 86 86 86 86 86 
0 0 0 0 0 0 0 0 0 0 0 0 0 166 168 0 0 0 0 0 206 86 86 86 86 86 86 86 86 86 86 86 86 86 86 86 86 86 86 86 
0 0 0 0 0 0 0 0 0 0 0 0 0 206 208 837 837 837 837 837 206 86 86 86 86 86 86 86 86 86 86 86 86 86 86 86 86 86 86 86 
0 0 0 0 0 0 0 0 0 0 0 0 0 246 248 0 0 0 0 0 206 86 86 86 86 86 86 86 86 86 86 86 86 86 86 86 86 86 86 86 
0 0 0 0 0 0 0 0 0 0 0 0 0 0 0 0 0 0 0 0 206 86 86 86 86 86 86 86 86 86 86 86 86 86 86 86 86 86 86 86 
0 0 0 0 0 0 0 0 0 0 0 0 0 0 0 0 0 0 0 0 246 247 247 247 247 247 247 247 247 247 247 247 247 247 247 247 247 247 247 247 
0 0 0 0 0 0 0 0 0 0 0 0 0 0 0 0 0 0 0 0 0 0 0 836 0 0 0 0 0 0 0 0 0 0 0 0 0 0 0 0 
0 0 0 0 0 0 0 0 0 0 0 0 0 0 0 0 0 0 0 0 0 0 0 836 0 0 0 0 0 0 0 0 0 0 0 0 0 0 0 0 
0 0 0 0 0 0 0 0 0 0 0 0 0 0 0 0 0 0 0 0 0 0 0 836 0 0 0 0 0 0 0 0 0 0 0 0 0 0 0 0 
0 0 0 0 0 0 0 0 0 0 0 0 0 0 0 0 0 0 0 0 0 0 0 836 0 0 0 0 0 0 0 0 0 0 0 0 0 0 0 0 
0 0 0 0 0 0 0 0 0 0 0 0 0 0 0 0 0 0 0 0 0 0 0 836 0 0 0 0 0 0 0 0 0 0 0 0 0 0 0 0 
0 0 0 0 0 0 0 0 0 0 0 0 0 0 0 0 0 0 0 0 0 0 166 167 168 0 0 0 0 0 0 0 0 0 0 0 0 0 0 0 
0 0 0 0 0 0 0 0 0 0 0 0 0 0 0 0 0 0 0 0 0 0 246 247 248 0 0 0 0 0 0 0 0 0 0 0 0 0 0 0 
0 0 0 0 0 0 0 0 0 0 0 0 0 0 0 0 0 0 0 0 0 0 0 0 0 0 0 0 0 0 0 0 0 0 0 0 0 0 0 0 
0 0 0 0 0 0 0 0 0 0 0 0 0 0 0 0 0 0 0 0 0 0 0 0 0 0 0 0 0 0 0 0 0 0 0 0 0 0 0 0 
0 0 0 0 0 0 0 0 0 0 0 0 0 0 0 0 0 0 0 0 0 0 0 0 0 0 0 0 0 0 0 0 0 0 0 0 0 0 0 0 
0 0 0 0 0 0 0 0 0 0 0 0 0 0 0 0 0 0 0 0 0 0 0 0 0 0 0 0 0 0 0 0 0 0 0 0 0 0 0 0 
0 0 0 0 0 0 0 0 0 0 0 0 0 0 0 0 0 0 0 0 0 0 0 0 0 0 0 0 0 0 0 0 0 0 0 0 0 0 0 0 
0 0 0 0 0 0 0 0 0 0 0 0 0 0 0 0 0 0 0 0 0 0 0 0 0 0 0 0 0 0 0 0 0 0 0 0 0 0 0 0 
0 0 0 0 0 0 0 0 0 0 0 0 0 0 0 0 0 0 0 0 0 0 0 0 0 0 0 0 0 0 0 0 0 0 0 0 0 0 0 0 
0 0 0 0 0 0 0 0 0 0 0 0 0 0 0 0 0 0 0 0 0 0 0 0 0 0 0 0 0 0 0 0 0 0 0 0 0 0 0 0 
0 0 0 0 0 0 0 0 0 0 0 0 0 0 0 0 0 0 0 0 0 0 0 0 0 0 0 0 0 0 0 0 0 0 0 0 0 0 0 0 
0 0 0 0 0 0 0 0 0 0 0 0 0 0 0 0 0 0 0 0 0 0 0 0 0 0 0 0 0 0 0 0 0 0 0 0 0 0 0 0 
0 0 0 0 0 0 0 0 0 0 0 0 0 0 0 0 0 0 0 0 0 0 0 0 0 0 0 0 0 0 0 0 0 0 0 0 0 0 0 0 
0 0 0 0 0 0 0 0 0 0 0 0 0 0 0 0 0 0 0 0 0 0 0 0 0 0 0 0 0 0 0 0 0 0 0 0 0 0 0 0 
0 0 0 0 0 0 0 0 0 0 0 0 0 0 0 0 0 0 0 0 0 0 0 0 0 0 0 0 0 0 0 0 0 0 0 0 0 0 0 0 
1
0 0 10 0
