292 292 292 292 292 292 292 292 292 292 292 292 292 292 292 292 292 292 292 292 292 292 292 292 292 292 292 292 292 292 292 292 292 292 292 292 292 292 292 292 
292 292 292 292 292 292 292 292 292 292 292 292 292 292 292 292 292 292 292 292 292 292 292 292 292 292 292 292 292 292 292 292 292 292 292 292 292 292 292 292 
292 292 292 292 292 292 292 292 292 292 292 292 292 292 292 292 292 292 292 292 292 292 292 292 292 292 292 292 292 292 292 292 292 292 292 292 292 292 292 292 
292 292 292 293 453 453 453 453 453 453 453 453 453 453 453 453 453 453 453 453 453 453 453 453 453 453 453 453 453 453 453 453 453 453 453 294 292 292 292 292 
292 292 292 414 0 0 0 0 0 0 0 0 0 0 0 0 0 0 0 0 0 0 0 0 0 0 0 0 0 0 0 0 0 0 0 412 292 292 292 292 
292 292 292 414 0 0 0 0 0 0 0 0 0 0 0 0 0 0 0 0 0 0 0 0 0 0 0 0 0 0 0 0 0 0 0 412 292 292 292 292 
292 292 292 414 0 0 0 0 0 0 0 0 0 0 0 0 0 0 0 0 0 0 0 0 0 0 0 0 0 0 0 0 0 0 0 412 292 292 292 292 
292 292 292 414 0 0 0 0 0 0 0 0 0 0 0 0 0 0 0 0 0 0 0 0 0 0 0 0 0 0 0 0 0 0 0 412 292 292 292 292 
292 292 292 414 0 0 0 0 0 0 0 0 0 0 0 0 0 0 0 0 0 0 0 0 0 0 0 0 0 0 0 0 0 0 0 412 292 292 292 292 
292 292 292 414 0 0 0 0 0 0 0 0 0 0 0 0 0 0 0 0 0 0 0 0 0 0 0 0 0 0 0 0 0 0 0 412 292 292 292 292 
292 292 292 414 0 0 0 0 0 0 0 0 0 0 0 0 0 0 0 0 0 0 0 0 0 0 0 0 0 0 0 0 0 0 0 412 292 292 292 292 
292 292 292 414 0 0 0 0 0 0 0 0 0 0 0 0 0 0 0 0 0 0 0 0 0 0 0 0 0 0 0 0 0 0 0 412 292 292 292 292 
292 292 292 414 0 0 0 0 0 0 0 0 0 0 0 0 0 0 0 0 0 0 0 0 0 0 0 0 0 0 0 0 0 0 0 412 292 292 292 292 
292 292 292 414 0 0 0 0 0 372 373 373 373 373 373 373 373 373 373 373 374 0 0 0 0 0 0 0 372 373 373 373 373 373 373 334 292 292 292 292 
292 292 292 414 0 0 0 0 0 412 292 292 292 292 292 292 292 292 292 292 414 0 0 0 0 0 0 0 412 292 292 292 292 292 292 292 292 292 292 292 
292 292 292 414 0 0 0 0 0 452 453 453 453 453 453 453 453 453 453 294 414 0 0 0 0 0 0 0 412 292 292 292 292 292 292 292 292 292 292 292 
292 292 292 414 0 0 0 0 0 0 0 0 0 0 0 0 0 0 0 412 414 0 0 0 0 0 0 0 412 292 292 292 292 292 292 292 292 292 292 292 
292 292 292 414 0 0 0 0 0 0 0 0 0 0 0 0 0 0 0 412 414 0 0 0 0 0 0 0 412 292 292 292 292 292 292 292 292 292 292 292 
292 292 292 414 0 0 0 0 0 0 0 0 0 0 0 0 0 0 0 412 414 0 0 0 0 0 0 0 412 292 292 292 292 292 292 292 292 292 292 292 
292 292 292 414 0 0 0 0 0 0 0 0 0 0 0 0 0 0 0 412 414 0 0 0 0 0 0 0 412 292 292 292 292 292 292 292 292 292 292 292 
453 453 453 454 0 0 0 0 0 0 0 0 0 0 0 0 0 0 0 412 414 0 0 0 0 0 0 0 412 292 292 292 292 292 292 292 292 292 292 292 
0 0 0 0 0 0 0 0 0 0 0 0 0 0 0 0 0 0 0 412 414 0 0 0 0 0 0 0 412 292 292 292 292 292 292 292 292 292 292 292 
0 0 0 0 0 0 0 0 0 0 0 0 0 0 0 0 0 0 0 412 414 0 0 0 0 0 0 0 412 292 292 292 292 292 293 453 453 453 453 453 
0 0 0 0 0 0 0 0 0 0 0 0 0 0 0 0 0 0 0 412 414 0 0 0 0 0 0 0 412 292 292 292 292 292 414 0 0 0 0 0 
0 0 0 0 0 0 0 0 0 0 0 0 0 0 0 0 0 0 0 412 414 0 0 0 0 0 0 0 412 292 292 292 292 292 414 0 0 0 0 0 
0 0 0 0 0 0 0 0 0 0 0 0 0 0 0 0 0 0 0 412 414 0 0 0 0 0 0 0 412 292 292 292 292 292 414 0 0 0 0 0 
373 373 373 373 373 373 373 373 373 373 373 373 373 373 373 373 373 373 373 334 414 0 0 0 0 0 0 0 412 292 292 292 292 292 333 373 373 373 373 373 
292 292 292 292 292 292 292 292 292 292 292 292 292 292 292 292 292 292 292 292 414 0 0 0 0 0 0 0 412 292 292 292 292 292 292 292 292 292 292 292 
292 292 292 292 292 292 292 292 292 292 292 292 292 292 292 292 292 292 292 292 414 0 0 0 0 0 0 0 412 292 292 292 292 292 292 292 292 292 292 292 
292 292 292 292 292 292 292 292 292 292 292 292 292 292 292 292 292 292 292 292 414 0 0 0 0 0 0 360 412 292 292 292 292 292 292 292 292 292 292 292 
8
32 11 10 1
16 11 10 1
13 11 10 1
10 11 10 1
16 16 10 0
16 24 10 1
13 24 10 1
10 24 10 1
