483 483 483 483 483 483 483 483 483 483 483 483 483 483 483 483 483 483 483 483 483 483 483 483 483 483 483 483 483 483 483 483 483 483 483 483 483 483 483 483 
483 483 483 483 483 483 483 483 483 483 483 483 483 483 483 483 483 483 483 483 483 483 483 483 483 483 483 483 483 483 483 483 483 483 483 483 483 483 483 483 
483 483 483 483 483 483 483 483 483 483 483 483 483 483 483 483 483 483 483 483 483 483 483 483 483 483 483 483 483 483 483 483 483 483 483 483 483 483 483 483 
483 483 483 483 483 483 483 483 483 483 483 483 483 483 483 483 483 483 483 483 483 483 483 483 483 483 483 483 483 483 483 483 483 483 483 483 483 483 483 483 
483 483 483 483 483 483 483 483 483 483 483 483 483 483 483 483 483 483 483 483 483 483 483 483 483 483 483 483 483 483 483 483 483 483 483 483 483 483 483 483 
483 483 483 483 483 483 483 483 483 483 483 483 483 483 483 483 483 483 483 483 483 483 483 483 483 483 483 483 483 483 483 483 483 483 483 483 483 483 483 483 
483 483 483 483 483 483 483 484 644 644 644 644 644 485 483 483 483 483 483 483 484 644 644 644 644 644 485 483 483 483 483 483 483 483 483 483 483 483 483 483 
483 483 483 483 483 483 483 605 7 7 7 7 7 603 483 483 483 483 483 483 605 7 7 7 7 7 603 483 483 483 483 483 483 483 483 483 483 483 483 483 
483 483 483 483 483 483 483 605 0 0 0 0 0 603 483 483 483 483 483 483 605 0 0 0 0 0 603 483 483 483 483 483 483 483 483 483 483 483 483 483 
483 483 483 483 483 483 483 605 0 0 0 0 0 603 483 483 483 483 483 483 605 0 0 0 0 0 603 483 483 483 483 483 483 483 483 483 483 483 483 483 
483 483 483 483 483 483 483 605 0 0 0 0 0 603 483 483 483 483 483 483 605 0 0 0 0 0 603 483 483 483 483 483 483 483 483 483 483 483 483 483 
483 483 483 483 483 483 483 605 0 0 0 0 0 603 483 483 483 483 483 483 605 0 0 0 0 0 603 483 483 483 483 483 483 483 483 483 483 483 483 483 
483 483 483 483 483 483 483 605 0 0 0 0 0 603 483 483 483 483 483 483 605 0 0 0 0 0 603 483 483 483 483 483 483 483 483 483 483 483 483 483 
644 644 644 644 644 644 644 645 0 0 0 0 0 643 644 644 644 644 644 644 645 0 0 0 0 0 603 483 483 483 483 483 483 483 483 483 483 483 483 483 
0 0 0 0 0 0 0 683 0 0 0 0 0 0 0 0 0 0 0 0 0 0 0 0 0 0 603 483 483 483 483 483 483 483 483 483 483 483 483 483 
0 0 0 0 0 0 0 683 0 0 0 0 0 0 0 0 0 0 0 0 0 0 0 0 0 0 643 644 644 644 644 644 644 644 644 644 644 644 644 644 
0 0 0 0 0 0 0 683 0 0 0 0 0 0 0 0 0 0 0 0 0 0 0 0 0 0 683 0 0 0 0 0 0 0 0 0 0 0 0 0 
0 0 0 0 0 0 0 683 0 0 0 0 0 0 0 0 0 0 0 0 0 0 0 0 0 0 683 0 0 0 0 0 0 0 0 0 0 0 0 0 
0 0 0 0 0 0 0 683 0 0 0 0 0 0 0 0 0 0 0 0 0 0 0 0 0 0 683 0 0 0 0 0 0 0 0 0 0 0 0 0 
0 0 0 0 0 684 684 685 684 684 684 684 684 684 684 684 684 684 684 684 684 684 684 684 684 684 685 684 0 0 0 0 0 0 0 0 0 0 0 0 
0 0 0 0 0 0 0 683 0 0 0 0 0 0 0 0 0 0 0 0 0 0 0 0 0 0 683 0 0 0 0 0 0 0 0 0 0 0 0 0 
0 0 0 0 0 0 0 683 0 0 0 0 0 0 0 0 0 0 0 0 0 0 0 0 0 0 683 0 0 0 0 0 0 0 0 0 0 0 0 0 
0 0 0 0 0 0 563 564 564 564 565 0 0 0 0 0 0 0 0 0 0 0 0 0 0 0 683 0 0 0 0 0 0 0 0 0 0 0 0 0 
0 0 0 0 0 0 643 644 644 644 645 0 0 0 0 0 0 0 0 0 0 0 0 0 0 0 683 0 0 0 0 0 0 0 0 0 0 0 0 0 
0 0 0 0 0 0 0 0 0 0 0 0 0 0 0 0 0 0 0 0 0 0 563 564 564 564 564 565 0 0 0 0 0 0 0 0 0 0 0 0 
0 0 0 0 0 0 0 0 0 0 0 0 0 0 0 0 0 0 0 0 0 0 643 644 644 644 644 645 0 0 0 0 0 0 0 0 0 0 0 0 
0 0 0 0 0 0 0 0 0 0 0 0 0 0 0 0 0 0 0 0 0 0 0 0 0 0 0 0 0 0 0 0 0 0 0 0 0 0 0 0 
6 6 6 6 6 6 6 0 0 0 0 0 0 0 0 0 0 0 0 0 0 0 0 0 0 0 0 0 0 0 0 0 0 0 0 0 0 0 0 0 
564 564 564 564 564 564 565 0 0 0 0 0 0 0 0 0 0 0 0 0 0 0 0 0 0 0 0 0 0 0 0 0 0 0 0 0 0 0 0 0 
483 483 483 483 483 483 605 0 0 0 0 0 0 0 0 0 0 0 0 0 0 0 0 0 0 0 0 0 0 0 0 0 0 0 0 0 0 0 0 0 
1
24 22 10 1
