498 498 620 0 0 0 0 0 0 0 618 498 498 498 498 498 498 498 498 498 498 498 498 498 498 498 498 498 498 498 498 498 498 498 498 498 498 498 498 498 
498 498 620 0 0 0 0 0 0 0 618 498 498 498 498 498 498 498 498 498 498 498 498 498 498 498 498 498 498 498 498 498 498 498 498 498 498 498 498 498 
498 498 620 0 0 0 0 0 0 0 618 498 498 498 498 498 498 498 498 498 498 498 498 498 498 498 498 498 498 498 498 498 498 498 498 498 498 498 498 498 
498 498 620 0 0 0 0 0 0 0 618 498 498 498 498 498 498 498 498 498 498 498 498 498 498 498 498 498 498 498 498 498 498 498 498 498 498 498 498 498 
498 498 620 0 0 0 0 0 0 0 618 498 498 498 498 498 498 498 498 498 498 498 498 498 498 498 498 498 498 498 499 659 659 500 498 498 498 498 498 498 
498 498 620 0 0 0 0 0 0 0 618 498 498 498 498 498 498 498 498 498 498 498 498 498 498 498 498 498 499 659 660 7 7 618 498 498 498 498 498 498 
498 498 620 0 0 0 0 0 0 0 618 498 498 498 498 498 498 498 498 498 498 498 498 498 498 499 659 659 660 7 7 0 0 618 498 498 498 498 498 498 
498 498 620 699 699 699 699 699 699 699 618 498 498 498 498 498 498 498 498 498 498 498 499 659 659 660 7 7 7 0 0 0 0 618 498 498 498 498 498 498 
498 498 620 0 0 0 0 0 0 0 618 498 498 498 498 498 498 498 498 498 498 498 620 7 7 7 0 0 0 0 0 0 0 658 659 659 659 659 659 659 
498 498 620 0 0 0 0 0 0 0 618 498 498 498 498 498 498 498 498 498 498 498 620 0 0 0 0 0 0 0 0 0 0 0 0 0 0 0 0 0 
498 498 620 0 0 0 0 0 0 0 658 500 498 498 498 498 498 498 499 659 659 500 620 0 0 0 0 0 0 0 0 0 0 0 0 0 0 0 0 0 
498 498 620 0 0 0 0 0 0 0 0 658 500 498 498 498 499 659 660 7 7 618 620 0 0 0 0 0 0 0 0 0 0 0 0 0 0 0 0 0 
498 498 620 0 0 0 0 0 0 0 0 0 658 659 659 659 660 0 0 0 0 618 620 0 0 0 0 0 0 0 0 0 0 0 0 0 0 0 0 0 
498 498 620 0 0 0 0 0 0 0 0 0 0 0 698 0 0 0 0 0 0 658 660 0 0 0 0 0 0 0 0 0 0 0 0 0 0 0 0 0 
498 498 620 0 0 0 0 0 0 0 0 0 0 0 698 0 0 0 0 0 0 0 0 0 0 0 0 0 0 0 0 0 0 0 0 0 0 0 0 0 
498 498 620 0 0 0 0 0 0 0 0 0 0 0 698 0 0 0 0 0 0 0 0 0 0 0 0 0 0 0 0 0 0 0 0 0 0 0 0 0 
498 498 620 0 0 0 0 0 0 0 0 0 0 0 698 0 0 0 0 0 0 0 0 0 0 0 0 0 0 0 0 0 0 0 0 0 0 0 0 0 
498 498 620 0 0 0 0 0 0 0 0 0 0 0 698 0 0 0 0 0 0 0 0 0 0 0 0 0 0 0 0 0 0 0 0 0 0 0 0 0 
498 498 620 0 0 0 0 0 0 0 0 0 0 0 698 0 0 0 0 0 0 0 0 0 0 0 0 0 0 0 0 0 0 0 0 0 0 0 0 0 
498 498 620 0 0 0 0 0 0 0 0 0 0 0 698 0 0 0 0 0 0 0 0 0 0 0 0 0 0 0 0 0 0 0 0 0 0 0 0 0 
498 498 620 0 0 0 0 0 0 0 0 0 0 0 698 0 0 0 0 0 0 0 0 0 0 0 0 0 0 0 0 0 0 0 0 0 0 0 0 0 
498 498 539 579 579 579 580 0 0 0 0 0 0 0 698 0 0 0 0 0 0 0 0 0 0 0 0 0 0 0 0 0 0 0 0 0 0 0 0 0 
498 498 498 498 498 498 539 580 0 0 0 0 0 0 698 0 0 0 0 0 0 0 0 0 0 0 0 0 0 0 0 0 0 0 0 0 0 0 0 0 
498 498 498 498 498 498 498 539 579 579 579 579 580 0 698 0 0 0 0 0 0 0 0 0 0 0 0 0 0 0 0 0 0 0 0 0 0 0 0 0 
498 498 498 498 498 498 498 498 498 498 498 498 539 579 579 580 0 0 0 0 0 0 0 0 0 578 580 0 0 0 0 0 0 0 0 0 0 0 0 0 
498 498 498 498 498 498 498 498 498 498 498 498 498 498 498 539 579 579 580 6 6 6 6 6 6 618 620 6 6 6 6 6 6 6 6 6 6 6 6 6 
498 498 498 498 498 498 498 498 498 498 498 498 498 498 498 498 498 498 539 579 579 579 579 579 579 540 539 579 579 579 579 579 579 579 579 579 579 579 579 579 
498 498 498 498 498 498 498 498 498 498 498 498 498 498 498 498 498 498 498 498 498 498 498 498 498 498 498 498 498 498 498 498 498 498 498 498 498 498 498 498 
498 498 498 498 498 498 498 498 498 498 498 498 498 498 498 498 498 498 498 498 498 498 498 498 498 498 498 498 498 498 498 498 498 498 498 498 498 498 498 498 
498 498 498 498 498 498 498 498 498 498 498 498 498 498 498 498 498 498 498 498 498 498 498 498 498 498 498 498 498 498 498 498 498 498 498 498 498 498 498 498 
1
9 21 10 1
