283 283 283 283 283 283 283 283 283 283 283 283 283 283 283 283 283 283 283 283 283 283 283 283 283 283 283 283 283 405 0 0 0 0 0 0 403 283 283 283 
283 284 444 444 444 444 444 444 444 444 444 444 444 444 444 285 283 283 283 283 283 283 283 283 283 283 283 283 283 405 0 0 0 0 0 0 403 283 283 283 
283 405 0 0 0 0 0 0 0 0 0 0 0 0 0 403 283 283 283 283 283 283 283 283 283 283 283 283 283 405 0 0 0 0 0 0 403 283 283 283 
283 405 0 0 0 0 0 0 0 0 0 0 0 0 0 403 283 283 283 283 283 283 283 283 283 283 283 283 283 405 0 0 0 0 0 0 403 283 283 283 
283 405 0 0 0 0 0 0 0 0 0 0 0 0 0 403 283 283 283 283 283 283 283 283 283 283 283 283 283 405 0 0 0 0 0 0 403 283 283 283 
283 405 0 0 0 0 0 0 0 0 0 0 0 0 0 403 283 283 283 283 283 283 283 283 283 283 283 283 283 405 0 0 0 0 0 0 403 283 283 283 
283 405 0 0 0 363 364 364 364 364 364 364 364 364 364 325 283 283 283 283 283 283 283 283 283 283 283 283 283 405 0 0 0 0 0 0 403 283 283 283 
283 405 0 0 0 403 283 283 283 283 283 283 283 283 283 283 283 283 283 283 283 283 283 283 283 283 283 283 283 405 0 0 0 0 0 0 403 283 283 283 
283 405 0 0 0 403 283 283 283 283 283 283 283 283 283 283 283 283 283 283 283 283 283 283 283 283 283 283 283 405 0 0 0 0 0 0 403 283 283 283 
283 405 0 0 0 403 283 283 283 283 283 283 283 283 283 283 283 283 283 283 283 283 283 283 283 283 283 283 283 405 0 0 0 0 0 0 403 283 283 283 
283 405 0 0 0 403 283 283 283 283 283 283 283 283 283 283 283 283 283 283 283 283 283 283 283 283 283 283 283 405 0 0 0 0 0 0 403 283 283 283 
283 405 0 0 0 403 283 283 283 283 283 283 283 283 283 283 283 283 283 283 283 283 283 283 283 283 283 283 283 405 0 0 0 0 0 0 403 283 283 283 
283 405 0 0 0 403 283 283 283 283 283 283 283 283 283 283 283 283 283 283 283 283 283 283 283 283 283 283 283 405 0 0 0 0 0 0 403 283 283 283 
283 405 0 0 0 403 283 283 283 283 283 283 283 283 283 283 283 283 283 283 283 283 283 283 283 283 283 283 283 405 0 0 0 0 0 0 403 283 283 283 
283 405 0 0 0 443 444 444 444 444 444 444 444 444 444 444 444 444 444 444 444 444 444 444 444 444 444 444 444 445 0 0 0 0 0 0 403 283 283 283 
283 405 0 0 0 0 0 0 0 0 0 0 0 0 0 0 0 0 0 0 0 0 0 0 0 0 0 0 0 0 0 0 0 0 0 0 403 283 283 283 
283 405 0 0 0 0 0 0 0 0 0 0 0 0 0 0 0 0 0 0 0 0 0 0 0 0 0 0 0 0 0 0 0 0 0 0 403 283 283 283 
283 405 0 0 0 0 0 0 0 0 0 0 0 0 0 0 0 0 0 0 0 0 0 0 0 0 0 0 0 0 0 0 0 0 0 0 403 283 283 283 
283 405 0 0 0 0 0 0 0 0 0 0 0 0 0 0 0 0 0 0 0 0 0 0 0 0 0 0 0 0 0 0 0 0 0 0 403 283 283 283 
283 405 0 0 0 0 0 0 0 0 0 0 0 0 0 0 0 0 0 0 0 0 0 0 0 0 0 0 0 0 0 0 0 0 0 0 403 283 283 283 
283 324 364 364 364 364 364 365 0 0 0 0 363 364 364 364 364 364 364 364 364 364 364 364 364 364 364 364 364 364 364 364 364 364 364 364 325 283 283 283 
283 283 283 283 283 283 283 405 0 0 0 0 403 283 283 283 283 283 283 283 283 283 283 283 283 283 283 283 283 283 283 283 283 283 283 283 283 283 283 283 
283 283 283 283 283 283 283 405 0 0 0 0 403 283 283 283 283 283 283 283 283 283 283 283 283 283 283 283 283 283 283 283 283 283 283 283 283 283 283 283 
283 283 283 283 283 283 283 405 0 0 0 0 403 283 283 283 283 283 283 283 283 283 283 283 283 283 283 283 283 283 283 283 283 283 283 283 283 283 283 283 
283 283 283 283 283 283 283 405 0 0 0 0 403 283 283 283 283 283 283 283 283 283 283 283 283 283 283 283 283 283 283 283 283 283 283 283 283 283 283 283 
283 283 283 283 283 283 283 405 0 0 0 0 403 283 283 283 283 283 283 283 283 283 283 283 283 283 283 283 283 283 283 283 283 283 283 283 283 283 283 283 
283 283 283 283 283 283 283 405 0 0 0 0 403 283 283 283 283 283 283 283 283 283 283 283 283 283 283 283 283 283 283 283 283 283 283 283 283 283 283 283 
283 283 283 283 283 283 283 324 364 364 364 364 325 283 283 283 283 283 283 283 283 283 283 283 283 283 283 283 283 283 283 283 283 283 283 283 283 283 283 283 
283 283 283 283 283 283 283 283 283 283 283 283 283 283 283 283 283 283 283 283 283 283 283 283 283 283 283 283 283 283 283 283 283 283 283 283 283 283 283 283 
283 283 283 283 283 283 283 283 283 283 283 283 283 283 283 283 283 283 283 283 283 283 283 283 283 283 283 283 283 283 283 283 283 283 283 283 283 283 283 283 
2
9 24 9
14 18 10 1
