495 495 495 495 495 495 617 0 0 0 0 0 0 0 0 0 0 0 0 0 0 0 0 0 0 0 0 0 0 0 0 0 0 0 0 0 0 0 0 0 
495 495 495 495 495 495 617 0 0 0 0 0 0 0 0 0 0 0 0 0 0 0 0 0 0 0 0 0 0 0 0 0 0 0 0 0 0 0 0 0 
495 495 495 495 495 495 617 0 0 0 0 0 0 0 0 0 0 0 0 0 0 0 0 0 0 0 0 0 0 0 0 0 0 0 0 0 0 0 0 0 
495 495 495 495 495 495 617 0 0 0 0 0 0 0 0 0 0 0 0 0 0 0 0 0 0 0 0 0 0 0 0 0 0 0 0 0 0 0 0 0 
495 495 495 495 495 495 617 0 0 0 0 0 0 0 0 0 0 0 0 0 0 0 0 0 0 0 0 0 0 0 0 0 0 0 0 0 0 0 0 0 
495 495 495 495 495 495 617 0 0 0 0 0 0 0 0 0 0 0 0 0 0 0 0 0 0 0 0 0 0 0 0 0 0 0 0 0 0 0 0 0 
495 495 495 495 495 495 617 0 0 0 0 0 0 0 0 0 0 0 0 0 0 0 0 0 0 0 0 0 0 0 0 0 0 0 0 0 0 0 0 0 
495 495 495 495 495 495 617 0 0 0 0 0 0 0 0 0 0 0 0 0 0 0 0 0 0 0 0 0 0 0 0 0 0 0 0 0 0 0 0 0 
495 495 495 495 495 495 617 0 0 0 0 0 0 0 0 0 0 0 0 0 0 0 0 0 0 0 0 0 0 0 0 0 0 0 0 0 0 0 0 0 
495 495 495 495 495 495 617 0 0 0 0 0 0 0 0 0 0 0 0 0 0 0 0 0 0 0 0 0 0 0 0 0 0 0 0 0 0 0 0 0 
495 495 495 495 495 495 617 0 0 0 0 0 0 0 0 0 0 0 0 0 0 0 0 0 0 0 0 0 0 0 0 0 0 0 0 0 0 0 0 0 
495 495 495 495 495 495 617 0 0 0 0 0 0 0 0 0 0 0 0 0 0 0 0 0 0 0 0 0 0 0 0 0 0 0 0 0 0 0 0 0 
495 495 495 495 495 495 617 0 0 0 0 0 0 0 0 0 0 0 0 0 0 0 0 0 0 0 0 0 0 0 0 0 0 0 0 0 0 0 0 0 
495 495 495 495 495 495 617 0 0 0 0 0 6 6 0 0 0 0 0 0 0 0 0 0 0 0 0 0 0 0 0 0 0 0 0 0 0 0 0 0 
495 495 495 495 495 495 617 0 0 0 0 0 575 577 0 0 0 0 0 0 0 6 6 0 0 0 0 0 0 0 0 6 6 0 0 0 0 0 0 0 
495 495 495 495 495 495 617 0 0 0 0 0 615 617 0 0 0 0 0 0 0 575 577 0 0 0 0 0 0 0 0 575 577 0 0 0 0 0 0 0 
495 495 495 495 495 495 617 0 0 0 0 0 615 617 0 0 0 0 0 0 0 615 617 0 0 0 0 0 0 0 0 615 617 0 0 0 0 0 0 0 
495 495 495 495 495 495 617 0 0 0 0 0 615 617 0 0 0 0 0 0 0 615 617 0 0 0 0 0 0 0 0 615 617 0 0 0 0 0 0 0 
495 495 495 495 495 495 617 0 0 0 0 0 615 617 0 0 0 0 0 0 0 615 617 0 0 0 0 0 0 0 0 615 617 0 0 0 0 0 0 0 
495 495 495 495 495 495 617 0 0 6 6 6 615 617 6 6 6 6 6 0 0 615 617 0 0 0 0 0 0 0 0 615 617 0 0 0 0 0 0 0 
495 495 495 495 495 495 617 0 0 575 576 576 537 536 576 576 576 576 577 6 6 615 617 6 6 6 6 6 6 0 0 615 617 0 0 0 0 0 0 0 
495 495 495 495 495 495 617 0 0 615 495 495 495 495 495 495 495 495 536 576 576 537 536 576 576 576 576 576 577 6 6 615 617 6 6 6 6 6 6 6 
656 656 656 656 656 656 657 0 0 615 495 495 495 495 495 495 495 495 495 495 495 495 495 495 495 495 495 495 536 576 576 537 536 576 576 576 576 576 576 576 
0 0 0 0 0 0 0 0 0 615 495 495 495 495 495 495 495 495 495 495 495 495 495 495 495 495 495 495 495 495 495 495 495 495 495 495 495 495 495 495 
0 0 0 0 0 0 0 0 0 615 495 495 495 495 495 495 495 495 495 495 495 495 495 495 495 495 495 495 495 495 495 495 495 495 495 495 495 495 495 495 
0 0 0 0 0 0 0 0 0 615 495 495 495 495 495 495 495 495 495 495 495 495 495 495 495 495 495 495 495 495 495 495 495 495 495 495 495 495 495 495 
576 576 576 576 576 576 576 576 576 537 495 495 495 495 495 495 495 495 495 495 495 495 495 495 495 495 495 495 495 495 495 495 495 495 495 495 495 495 495 495 
495 495 495 495 495 495 495 495 495 495 495 495 495 495 495 495 495 495 495 495 495 495 495 495 495 495 495 495 495 495 495 495 495 495 495 495 495 495 495 495 
495 495 495 495 495 495 495 495 495 495 495 495 495 495 495 495 495 495 495 495 495 495 495 495 495 495 495 495 495 495 495 495 495 495 495 495 495 495 495 495 
495 495 495 495 495 495 495 495 495 495 495 495 495 495 495 495 495 495 495 495 495 495 495 495 495 495 495 495 495 495 495 495 495 495 495 495 495 495 495 495 
1
5 24 10 1
