498 498 498 498 498 498 498 498 498 498 498 498 498 498 498 498 498 498 498 498 498 498 498 498 498 498 498 498 498 498 498 498 498 498 498 498 498 498 498 498 
498 498 498 498 498 498 498 498 498 498 498 498 498 498 498 498 498 498 498 498 498 498 498 498 498 498 498 498 498 498 498 498 498 498 498 498 498 498 498 498 
498 498 498 498 498 498 498 498 498 498 498 498 498 498 498 498 498 498 498 498 498 498 498 498 498 498 498 498 498 498 498 498 498 498 498 498 498 498 498 498 
498 498 498 498 498 498 498 498 498 498 498 498 498 498 498 498 498 499 659 659 659 659 659 659 659 659 659 659 659 659 659 659 659 659 659 659 659 659 659 659 
498 498 498 498 498 498 498 498 498 498 498 498 498 498 498 499 659 660 0 0 0 0 698 0 0 0 0 0 0 698 0 0 0 0 0 0 0 698 0 0 
498 498 498 498 498 498 498 498 498 498 498 498 498 499 659 660 0 0 0 0 0 0 698 0 0 0 0 0 0 698 0 0 0 0 0 0 0 698 0 0 
498 498 498 498 498 498 498 498 498 498 498 499 659 660 0 0 0 0 0 0 0 0 698 0 0 0 0 0 0 698 0 0 0 0 0 0 0 698 0 0 
498 498 498 498 498 498 498 498 498 498 498 620 0 0 0 0 0 0 0 0 0 0 698 0 0 0 0 0 0 698 0 0 578 579 579 579 579 579 579 579 
498 498 498 498 498 498 498 498 498 498 499 660 0 0 0 0 0 0 0 0 0 0 698 0 0 0 0 578 579 579 579 579 540 498 498 498 498 498 498 498 
498 498 498 498 498 498 498 498 498 498 620 0 0 0 0 0 0 0 0 0 0 0 698 0 578 579 579 540 498 498 498 498 498 498 498 498 498 498 498 498 
498 498 498 498 498 498 498 498 498 499 660 0 0 0 0 0 0 0 0 0 0 0 698 0 618 498 498 498 498 498 498 498 498 498 498 498 498 498 498 498 
498 498 498 498 498 498 498 498 498 620 0 0 0 0 0 0 0 0 0 0 0 0 578 579 540 498 498 498 498 498 498 498 498 498 498 498 498 498 498 498 
498 498 498 498 498 498 498 498 498 620 0 0 0 0 0 0 0 0 0 0 578 579 540 498 498 498 498 498 498 498 498 498 498 498 498 498 498 498 498 498 
498 498 498 498 498 498 498 498 498 620 0 0 0 0 0 0 0 0 578 579 540 498 498 498 498 498 498 498 498 498 498 498 498 498 498 498 498 498 498 498 
498 498 498 498 498 498 498 498 499 660 0 0 0 0 0 0 0 0 618 498 498 498 498 498 498 498 498 498 498 498 498 498 498 498 498 498 498 498 498 498 
498 498 498 498 498 498 498 498 620 0 0 0 0 0 0 0 0 0 618 498 498 498 498 498 498 498 498 498 498 498 498 498 498 498 498 498 498 498 498 498 
498 498 498 498 498 498 498 498 620 699 699 699 699 699 699 699 699 699 618 498 498 498 498 498 498 498 498 498 498 498 498 498 498 498 498 498 498 498 498 498 
498 498 498 498 498 498 498 498 620 0 0 0 0 0 0 0 0 0 618 498 498 498 498 498 498 498 498 498 498 498 498 498 498 498 498 498 498 498 498 498 
498 498 498 498 498 498 498 498 620 0 0 0 0 0 0 0 0 0 618 498 498 498 498 498 498 498 498 498 498 498 498 498 498 498 498 498 498 498 498 498 
498 498 498 498 498 498 498 498 620 0 0 0 0 0 0 0 0 0 658 659 500 498 498 498 498 498 498 498 498 498 498 498 498 498 498 498 498 498 498 498 
498 498 498 498 498 498 498 498 620 0 0 0 0 0 0 0 0 0 0 0 658 659 500 498 498 498 498 498 498 498 498 498 498 498 498 498 498 498 498 498 
498 498 498 498 498 498 498 498 620 0 0 0 0 0 0 0 0 0 0 0 0 0 658 659 500 498 498 498 498 498 498 498 498 498 498 498 498 498 498 498 
498 498 498 498 498 498 498 498 620 0 0 0 0 0 0 0 0 0 0 0 0 0 0 0 658 659 500 498 498 498 498 498 498 498 498 498 498 498 498 498 
498 498 498 498 498 498 498 499 660 0 0 0 0 0 0 0 0 0 0 0 0 0 0 0 0 0 658 659 659 659 659 659 659 659 659 659 659 659 659 659 
498 498 498 498 498 498 498 620 0 0 0 0 0 0 0 0 0 0 0 0 0 0 0 0 0 0 0 0 0 0 0 0 0 0 0 0 0 0 0 0 
498 498 498 498 498 498 498 620 0 0 0 0 0 0 0 0 0 0 0 0 0 0 0 0 0 0 0 0 0 0 0 0 0 0 0 0 0 0 0 0 
498 498 498 498 498 498 499 660 0 0 0 0 0 0 0 0 0 0 0 0 0 0 0 0 0 0 0 0 0 0 0 0 0 0 0 0 0 0 0 0 
498 498 498 498 498 498 620 0 0 0 0 0 0 0 0 0 0 0 0 0 0 0 0 0 0 0 0 0 0 0 0 0 0 0 0 0 0 0 0 0 
498 498 498 498 498 498 620 0 0 0 0 0 0 0 0 0 0 0 0 0 0 0 0 0 0 0 0 0 0 0 0 0 0 0 0 0 0 0 0 0 
498 498 498 498 498 498 620 0 0 0 0 0 0 0 0 0 0 0 0 0 0 0 0 0 0 0 0 0 0 0 0 0 0 0 0 0 0 0 0 0 
0
