212 92 92 214 252 253 253 254 212 92 92 214 212 92 92 214 212 92 92 214 212 92 92 214 212 92 92 214 212 92 92 214 212 92 92 214 212 92 92 214 
212 92 92 214 0 0 0 0 252 253 253 254 212 92 92 214 212 92 92 214 212 92 92 214 212 92 92 214 212 92 92 214 212 92 92 214 212 92 92 214 
212 92 92 214 0 0 0 0 0 0 0 0 252 253 253 254 212 92 92 214 212 92 92 214 212 92 92 214 212 92 92 214 212 92 92 214 212 92 92 214 
212 92 92 214 0 0 0 0 0 0 0 0 0 0 0 0 212 92 92 214 212 92 92 214 212 92 92 214 212 92 92 214 212 92 92 214 212 92 92 214 
212 92 92 214 0 0 0 0 0 0 0 0 0 0 0 0 212 92 92 214 252 253 253 254 212 92 92 214 212 92 92 214 212 92 92 214 212 92 92 214 
212 92 92 214 0 0 0 0 0 0 0 0 0 0 0 0 212 92 92 214 0 0 0 0 252 253 253 254 212 92 92 214 212 92 92 214 212 92 92 214 
212 92 92 214 0 0 0 0 0 0 0 0 0 0 0 0 212 92 92 214 0 0 0 0 0 0 0 0 252 253 253 254 212 92 92 214 212 92 92 214 
212 92 92 214 0 0 0 0 0 0 0 0 0 0 0 0 212 92 92 214 0 0 0 0 0 0 0 0 0 0 0 0 212 92 92 214 212 92 92 214 
252 253 253 254 0 0 0 0 0 0 0 0 0 0 0 0 252 253 253 254 0 0 0 0 0 0 0 0 0 0 0 0 212 92 92 214 252 253 253 254 
0 0 0 0 0 0 0 0 172 173 173 174 0 0 0 0 0 0 0 0 0 0 0 0 0 0 0 0 0 0 0 0 212 92 92 214 0 0 0 0 
0 0 0 0 0 0 0 0 212 92 92 214 0 0 0 0 0 0 0 0 0 0 0 0 0 0 0 0 0 0 0 0 212 92 92 214 0 0 0 0 
0 0 0 0 0 0 0 0 212 92 92 214 0 0 0 0 172 173 173 174 0 0 0 0 0 0 0 0 0 0 0 0 212 92 92 214 0 0 0 0 
0 0 0 0 0 0 0 0 212 92 92 214 0 0 0 0 252 253 253 254 0 0 0 0 0 0 0 0 0 0 0 0 212 92 92 214 0 0 0 0 
0 0 0 0 0 0 0 0 212 92 92 214 0 0 0 0 0 0 0 0 0 0 0 0 172 173 173 174 0 0 0 0 212 92 92 214 0 0 0 0 
0 0 0 0 0 0 0 0 212 92 92 214 0 0 0 0 0 0 0 0 0 0 0 0 252 253 253 254 0 0 0 0 212 92 92 214 0 0 0 0 
0 0 0 0 0 0 0 0 212 92 92 214 0 0 0 0 0 0 0 0 0 0 0 0 0 0 0 0 0 0 0 0 212 92 92 214 0 0 0 0 
172 173 173 174 0 0 0 0 212 92 92 214 0 0 0 0 0 0 0 0 0 0 0 0 0 0 0 0 0 0 0 0 252 253 253 254 172 173 173 174 
252 253 253 254 172 173 173 174 212 92 92 214 0 0 0 0 0 0 0 0 0 0 0 0 172 173 173 174 0 0 0 0 0 0 0 0 252 253 253 254 
0 0 0 0 252 253 253 254 212 92 92 214 0 0 0 0 0 0 0 0 0 0 0 0 212 92 92 214 0 0 0 0 0 0 0 0 0 0 0 0 
0 0 0 0 0 0 0 0 252 253 253 254 172 173 173 174 0 0 0 0 0 0 0 0 212 92 92 214 0 0 0 0 0 0 0 0 0 0 0 0 
0 0 0 0 0 0 0 0 0 0 0 0 252 253 253 254 172 173 173 174 0 0 0 0 212 92 92 214 0 0 0 0 0 0 0 0 0 0 0 0 
0 0 0 0 0 0 0 0 0 0 0 0 0 0 0 0 252 253 253 254 172 173 173 174 212 92 92 214 0 0 0 0 0 0 0 0 0 0 0 0 
0 0 0 0 0 0 0 0 0 0 0 0 0 0 0 0 0 0 0 0 212 92 92 214 212 92 92 214 0 0 0 0 0 0 0 0 0 0 0 0 
0 0 0 0 0 0 0 0 0 0 0 0 0 0 0 0 0 0 0 0 212 92 92 214 212 92 92 214 172 173 173 174 0 0 0 0 0 0 0 0 
0 0 0 0 0 0 0 0 0 0 0 0 0 0 0 0 0 0 0 0 212 92 92 214 212 92 92 214 212 92 92 214 172 173 173 174 0 0 0 0 
172 173 173 174 0 0 0 0 0 0 0 0 0 0 0 0 0 0 0 0 212 92 92 214 212 92 92 214 212 92 92 214 212 92 92 214 172 173 173 174 
212 92 92 214 172 173 173 174 0 0 0 0 0 0 0 0 0 0 0 0 212 92 92 214 212 92 92 214 212 92 92 214 212 92 92 214 212 92 92 214 
212 92 92 214 212 92 92 214 172 173 173 174 0 0 0 0 0 0 0 0 212 92 92 214 212 92 92 214 212 92 92 214 212 92 92 214 212 92 92 214 
212 92 92 214 212 92 92 214 212 92 92 214 172 173 173 174 0 0 0 0 212 92 92 214 212 92 92 214 212 92 92 214 212 92 92 214 212 92 92 214 
4
12 9 1 3 8 64 56 256 152
30 15 1 2 8 64 56 256 152
9 2 10 0
33 22 10 1
