95 95 95 95 95 217 7 7 7 7 7 7 215 95 95 95 95 217 215 95 95 217 215 95 95 95 95 217 7 7 7 7 7 7 215 95 95 95 95 95 
256 256 256 256 256 257 0 0 0 0 0 0 255 256 256 256 256 257 215 95 95 217 255 256 256 256 256 257 0 0 0 0 0 0 255 256 256 256 256 256 
7 7 7 7 7 7 0 0 0 0 0 0 7 7 7 7 7 7 215 95 95 217 7 7 7 7 7 7 0 0 0 0 0 0 7 7 7 7 7 7 
0 0 0 0 0 0 0 0 0 0 0 0 0 0 0 0 0 0 215 95 95 217 0 0 0 0 0 0 0 0 0 0 0 0 0 0 0 0 0 0 
0 0 0 0 0 0 0 0 0 0 0 0 0 0 0 0 0 0 215 95 95 217 0 0 0 0 0 0 0 0 0 0 0 0 0 0 0 0 0 0 
0 0 0 0 0 0 0 0 0 0 0 0 0 0 0 0 0 0 215 95 95 217 0 0 0 0 0 0 0 0 0 0 0 0 0 0 0 0 0 0 
0 0 0 0 0 0 0 0 0 0 0 0 0 0 0 0 0 0 215 95 95 217 0 0 0 0 0 0 0 0 0 0 0 0 0 0 0 0 0 0 
176 176 176 176 177 0 0 0 0 0 0 0 0 0 0 0 0 0 215 95 95 217 0 0 0 0 0 0 0 0 0 0 0 0 0 175 177 175 176 176 
256 256 256 256 257 0 0 0 0 0 0 0 0 0 0 0 0 0 255 256 256 257 0 0 0 0 0 0 0 0 0 0 0 0 0 215 217 255 256 256 
0 0 175 176 177 0 0 0 0 0 0 0 175 176 176 176 176 176 176 176 176 176 176 176 176 176 177 0 0 0 0 0 0 0 0 215 217 0 0 0 
0 0 215 95 217 0 0 0 0 0 0 0 215 95 95 95 95 95 95 95 95 95 95 95 95 95 217 0 0 0 0 0 0 0 0 215 217 0 0 0 
0 0 255 256 257 0 0 0 0 0 0 0 215 95 95 95 95 95 95 95 95 95 95 95 95 95 217 0 0 0 0 0 0 0 0 215 217 0 0 0 
0 0 0 0 0 0 0 0 0 0 0 0 255 256 256 256 256 256 256 256 256 256 256 256 256 256 257 0 0 0 0 0 0 0 0 215 217 0 0 0 
0 0 0 0 0 0 0 0 0 0 0 0 175 177 0 0 175 177 0 0 0 0 175 176 176 176 177 0 0 0 0 0 0 0 0 215 217 0 0 0 
0 0 0 0 0 0 0 0 0 0 0 0 215 217 0 0 215 217 0 0 0 0 215 95 95 95 217 0 0 0 0 0 0 0 0 215 217 0 0 0 
0 0 0 0 0 0 0 0 0 0 0 0 215 217 0 0 215 217 0 0 0 0 215 95 95 95 217 0 0 0 0 0 0 0 0 215 217 0 0 0 
0 0 0 0 0 0 0 0 0 0 0 0 215 217 0 0 215 217 0 0 0 0 215 95 95 95 217 0 0 0 0 0 0 0 0 215 217 0 0 0 
0 0 0 175 177 0 0 0 0 0 0 0 215 217 0 0 255 257 0 0 0 0 215 95 95 95 217 0 0 0 0 0 0 0 0 215 217 0 0 0 
0 0 0 215 217 0 0 0 0 0 0 0 215 217 0 0 0 0 0 0 0 0 215 95 95 95 217 0 0 0 0 0 0 0 0 215 217 0 0 0 
0 0 0 215 217 0 0 0 0 0 0 0 215 217 0 0 0 0 0 0 0 0 255 256 256 256 257 0 0 0 0 0 0 0 0 215 217 0 0 0 
0 0 0 255 257 0 0 0 0 0 0 0 215 217 0 0 0 0 0 0 0 0 0 0 0 0 0 0 0 0 0 0 0 0 0 255 257 0 0 0 
176 177 175 176 177 0 0 0 0 0 0 0 255 257 0 0 0 0 0 0 0 0 0 0 0 0 0 0 0 0 0 0 0 0 0 175 176 177 175 176 
95 217 255 256 257 0 0 0 0 0 0 0 0 0 0 0 175 177 0 0 0 0 0 0 0 0 0 0 0 0 0 0 0 0 0 255 256 257 215 95 
95 217 0 0 0 0 0 0 0 0 0 0 0 0 0 0 215 217 0 0 0 0 0 0 0 0 0 0 0 0 0 0 0 0 0 0 0 0 215 95 
95 217 0 0 0 0 0 0 0 0 0 0 0 0 0 0 215 217 0 0 0 0 0 0 0 0 0 0 0 0 0 0 0 0 0 0 0 0 215 95 
95 217 0 0 0 0 0 0 0 0 0 0 0 0 0 0 215 217 0 0 0 0 0 0 0 0 0 0 0 0 0 0 0 0 0 0 0 0 215 95 
256 257 6 6 6 6 0 0 0 0 0 0 6 6 6 6 255 257 6 6 6 6 6 6 6 6 6 6 0 0 0 0 0 0 6 6 6 6 255 256 
176 176 176 176 176 177 0 0 0 0 0 0 175 176 176 176 176 176 176 176 176 176 176 176 176 176 176 177 0 0 0 0 0 0 175 176 176 176 176 176 
95 95 95 95 95 217 6 6 6 6 6 6 215 95 95 95 95 95 95 95 95 95 95 95 95 95 95 217 6 6 6 6 6 6 215 95 95 95 95 95 
5
19 14 9
7 14 2 1 2 -32 -40 352 264
29 14 2 0 2 -32 -40 352 264
3 15 10 1
14 13 9
