83 83 205 0 0 0 0 203 205 0 0 0 0 0 0 0 0 0 0 0 0 0 0 0 0 203 205 0 0 0 0 203 205 0 0 0 0 203 83 83 
83 83 205 0 0 0 0 203 205 0 0 0 0 0 0 0 0 0 0 0 0 0 0 0 0 203 205 0 0 0 0 203 205 0 0 0 0 203 83 83 
83 83 205 0 0 0 0 203 205 0 0 0 0 0 0 0 0 0 0 0 0 0 0 0 0 203 205 0 0 0 0 203 205 0 0 0 0 203 83 83 
83 83 205 0 0 0 0 203 205 0 0 0 0 0 0 0 0 0 0 0 0 0 0 0 0 203 205 0 0 0 0 203 205 0 0 0 0 203 83 83 
244 244 245 0 0 0 0 243 245 0 0 0 0 0 0 0 0 0 0 0 0 0 0 0 0 243 245 0 0 0 0 243 245 0 0 0 0 243 244 244 
0 0 0 0 0 0 163 165 0 0 0 0 163 165 0 0 0 0 163 164 164 164 164 164 164 165 0 0 0 0 163 165 0 0 0 0 0 0 0 0 
0 0 0 0 0 0 203 205 0 0 0 0 203 205 0 0 0 0 203 83 83 83 83 83 83 205 0 0 0 0 203 205 0 0 0 0 0 0 0 0 
0 0 0 0 0 0 203 205 0 0 0 0 203 205 0 0 0 0 203 83 83 83 83 83 83 205 0 0 0 0 203 205 0 0 0 0 0 0 0 0 
0 0 0 0 0 0 243 245 0 0 0 0 243 245 0 0 0 0 243 244 244 244 244 244 244 245 0 0 0 0 243 245 0 0 0 0 0 0 0 0 
164 164 164 164 164 164 165 0 0 0 0 163 165 0 0 0 0 163 165 0 0 0 0 163 165 0 0 0 0 163 165 0 0 0 0 163 164 164 164 164 
83 83 83 83 83 83 205 0 0 0 0 203 205 0 0 0 0 203 205 0 0 0 0 203 205 0 0 0 0 203 205 0 0 0 0 203 83 83 83 83 
83 83 83 83 83 83 205 0 0 0 0 203 205 0 0 0 0 203 205 0 0 0 0 203 205 0 0 0 0 203 205 0 0 0 0 203 83 83 83 83 
244 244 244 244 244 244 245 0 0 0 0 243 245 0 0 0 0 243 245 0 0 0 0 243 245 0 0 0 0 243 245 0 0 0 0 243 244 244 244 244 
0 0 0 0 163 165 0 0 0 0 163 165 0 0 0 0 163 165 0 0 0 0 163 165 0 0 0 0 163 165 0 0 0 0 163 165 0 0 0 0 
0 0 0 0 203 205 0 0 0 0 203 205 0 0 0 0 203 205 0 0 0 0 203 205 0 0 0 0 203 205 0 0 0 0 203 205 0 0 0 0 
0 0 0 0 203 205 0 0 0 0 203 205 0 0 0 0 203 205 0 0 0 0 203 205 0 0 0 0 203 205 0 0 0 0 203 205 0 0 0 0 
0 0 0 0 243 245 0 0 0 0 243 245 0 0 0 0 243 245 0 0 0 0 243 245 0 0 0 0 243 245 0 0 0 0 243 245 0 0 0 0 
0 0 0 163 165 0 0 0 0 163 165 0 0 0 0 163 165 0 0 0 0 0 0 0 0 0 0 163 165 0 0 0 0 163 165 0 0 0 0 0 
0 0 0 203 205 0 0 0 0 203 205 0 0 0 0 203 205 0 0 0 0 0 0 0 0 0 0 203 205 0 0 0 0 203 205 0 0 0 0 0 
0 0 0 203 205 0 0 0 0 203 205 0 0 0 0 203 205 0 0 0 0 0 0 0 0 0 0 203 205 0 0 0 0 203 205 0 0 0 0 0 
0 0 0 243 245 0 0 0 0 243 245 0 0 0 0 243 245 0 0 0 0 0 0 0 0 0 0 243 245 0 0 0 0 243 245 0 0 0 0 0 
164 164 164 165 0 0 0 0 163 165 0 0 0 0 163 164 164 164 164 164 164 164 164 164 164 164 164 165 0 0 0 0 163 165 0 0 0 0 163 164 
83 83 83 205 0 0 0 0 203 205 0 0 0 0 203 83 83 83 83 83 83 83 83 83 83 83 83 205 0 0 0 0 203 205 0 0 0 0 203 83 
83 83 83 205 0 0 0 0 203 205 0 0 0 0 203 83 83 83 83 83 83 83 83 83 83 83 83 205 0 0 0 0 203 205 0 0 0 0 203 83 
244 244 244 245 0 0 0 0 243 245 0 0 0 0 243 244 244 244 244 244 244 244 244 244 244 244 244 245 0 0 0 0 243 245 0 0 0 0 243 244 
164 164 165 0 0 0 0 163 165 0 0 0 0 0 0 0 0 0 0 0 0 0 0 0 0 163 165 0 0 0 0 163 165 0 0 0 0 163 164 164 
83 83 205 0 0 0 0 203 205 0 0 0 0 0 0 0 0 0 0 0 0 0 0 0 0 203 205 0 0 0 0 203 205 0 0 0 0 203 83 83 
83 83 205 0 0 0 0 203 205 0 0 0 0 0 0 0 0 0 0 0 0 0 0 0 0 203 205 0 0 0 0 203 205 0 0 0 0 203 83 83 
83 83 205 0 0 0 0 203 205 0 0 0 0 0 0 0 0 0 0 0 0 0 0 0 0 203 205 0 0 0 0 203 205 0 0 0 0 203 83 83 
1
19 14 9
