740 740 218 98 220 0 0 0 0 0 218 98 220 740 740 740 740 740 740 740 740 740 740 740 740 740 740 740 740 740 740 740 740 740 740 740 740 740 740 740 
179 179 140 98 220 0 0 0 0 0 218 98 139 179 179 179 179 179 179 179 179 179 179 179 179 179 179 179 179 179 179 179 179 179 179 179 179 179 179 179 
98 98 98 98 220 0 0 0 0 0 218 98 98 98 98 98 98 98 98 98 98 98 98 98 98 98 98 98 98 98 98 98 98 98 98 98 98 98 98 98 
259 259 259 259 260 0 0 0 0 0 258 259 259 259 259 259 259 259 259 259 259 259 259 259 259 259 259 259 259 259 259 259 259 259 259 259 259 259 259 259 
0 0 0 0 0 0 0 0 0 0 740 740 740 740 0 0 0 0 0 0 0 0 0 0 0 0 0 0 0 0 740 740 740 740 740 740 0 0 0 0 
0 0 0 0 0 0 0 0 0 0 740 740 740 0 0 0 0 0 0 0 0 0 0 0 0 0 0 0 0 0 0 740 740 740 740 0 0 0 0 0 
0 0 0 0 0 0 0 0 0 0 740 740 0 0 0 0 0 0 0 0 0 0 0 0 0 0 0 0 0 0 0 0 740 740 740 0 0 0 0 0 
0 0 0 0 0 0 0 0 0 0 740 740 0 0 0 0 0 0 0 0 0 0 0 0 0 0 0 0 0 0 0 0 0 740 740 0 0 0 0 0 
0 0 0 0 0 0 0 0 0 740 740 740 0 0 0 0 0 740 740 740 740 740 740 740 740 740 740 740 0 0 0 0 0 740 740 740 0 0 0 0 
740 740 740 740 740 740 740 740 740 740 740 740 0 0 0 0 740 740 740 740 740 740 740 740 740 740 740 740 740 0 0 0 0 740 740 740 740 740 740 740 
740 740 740 740 740 740 740 740 740 740 740 740 0 0 0 740 740 740 740 0 0 0 0 0 0 740 740 740 740 0 0 0 0 740 740 740 740 740 740 740 
740 740 740 740 740 740 740 740 740 740 740 740 0 0 0 740 740 740 0 0 0 0 0 0 0 0 740 740 740 0 0 0 0 740 740 740 740 740 740 740 
740 740 740 740 740 740 740 740 740 740 740 740 0 0 0 740 740 740 0 0 0 0 0 0 0 0 0 0 0 0 0 0 0 740 740 740 740 740 740 740 
0 0 0 0 0 0 0 0 0 740 740 740 0 0 0 740 740 740 0 0 0 0 0 0 0 0 0 0 0 0 0 0 0 740 740 740 0 0 0 0 
0 0 0 0 0 0 0 0 0 0 740 740 0 0 0 740 740 740 0 0 0 0 0 0 0 0 0 0 0 0 0 0 740 740 740 0 0 0 0 0 
0 0 0 0 0 0 0 0 0 0 740 740 0 0 0 740 740 740 0 0 0 0 0 0 0 0 0 0 0 0 0 740 740 740 740 0 0 0 0 0 
0 0 0 0 0 0 0 0 0 0 740 740 0 0 0 740 740 740 740 740 740 740 740 740 740 740 740 740 740 740 740 740 740 740 740 0 0 0 0 0 
0 0 0 0 0 0 0 0 0 0 740 740 0 0 0 0 740 740 740 740 740 740 740 740 740 740 740 740 740 740 740 740 740 740 0 0 0 0 0 0 
0 0 0 0 0 0 0 0 0 0 740 740 0 0 0 0 0 740 740 740 740 740 740 740 740 740 740 740 740 740 740 740 740 0 0 0 0 0 0 0 
0 0 0 0 0 0 0 0 0 0 740 740 0 0 0 0 0 0 0 0 0 0 0 0 0 0 0 0 0 0 0 0 0 0 0 0 0 0 0 0 
0 0 0 0 0 0 0 0 0 0 740 740 0 0 0 0 0 0 0 0 0 0 0 0 0 0 0 0 0 0 0 0 0 0 0 0 0 0 0 0 
0 0 0 0 0 0 0 0 0 0 740 740 740 0 0 0 0 0 0 0 0 0 0 0 0 0 0 0 0 0 0 0 0 0 0 0 0 0 0 0 
0 0 0 0 0 0 0 0 0 0 740 740 740 740 0 0 0 0 0 0 0 0 0 0 0 0 0 0 0 0 0 0 0 0 0 0 0 0 0 0 
179 179 179 179 180 0 0 0 0 0 178 179 179 179 179 179 179 179 179 179 179 179 179 179 179 179 179 179 179 179 179 179 179 179 179 179 179 179 179 179 
98 98 98 98 220 0 0 0 0 0 218 98 98 98 98 98 98 98 98 98 98 98 98 98 98 98 98 98 98 98 98 98 98 98 98 98 98 98 98 98 
259 259 100 98 220 0 0 0 0 0 218 98 99 259 259 259 259 259 259 259 259 259 259 259 259 259 259 259 259 259 259 259 259 259 259 259 259 259 259 259 
740 740 218 98 220 0 0 0 0 0 218 98 220 740 740 740 740 740 740 740 740 740 740 740 740 740 740 740 740 740 740 740 740 740 740 740 740 740 740 740 
740 740 218 98 220 0 0 0 0 0 218 98 220 740 740 740 740 740 740 740 740 740 740 740 740 740 740 740 740 740 740 740 740 740 740 740 740 740 740 740 
740 740 218 98 220 0 0 0 0 0 218 98 220 740 740 740 740 740 740 740 740 740 740 740 740 740 740 740 740 740 740 740 740 740 740 740 740 740 740 740 
2
33 21 10 1
19 14 10 0
