218 98 98 220 218 98 98 220 218 98 98 220 218 98 98 220 218 98 98 220 218 98 98 220 218 98 98 220 218 98 98 220 218 98 98 220 218 98 98 220 
218 98 98 220 218 98 98 220 218 98 98 220 218 98 98 220 218 98 98 220 218 98 98 220 258 259 259 260 218 98 98 220 218 98 98 220 218 98 98 220 
218 98 98 220 218 98 98 220 218 98 98 220 258 259 259 260 218 98 98 220 258 259 259 260 0 0 0 0 258 259 259 260 218 98 98 220 218 98 98 220 
218 98 98 220 218 98 98 220 258 259 259 260 0 0 0 0 218 98 98 220 0 0 0 0 0 0 0 0 0 0 0 0 218 98 98 220 218 98 98 220 
218 98 98 220 258 259 259 260 0 0 0 0 0 0 0 0 218 98 98 220 0 0 0 0 0 0 0 0 0 0 0 0 218 98 98 220 218 98 98 220 
218 98 98 220 0 0 0 0 0 0 0 0 0 0 0 0 218 98 98 220 0 0 0 0 0 0 0 0 0 0 0 0 218 98 98 220 218 98 98 220 
218 98 98 220 0 0 0 0 0 0 0 0 0 0 0 0 218 98 98 220 0 0 0 0 0 0 0 0 0 0 0 0 218 98 98 220 218 98 98 220 
218 98 98 220 0 0 0 0 0 0 0 0 0 0 0 0 218 98 98 220 0 0 0 0 0 0 0 0 0 0 0 0 218 98 98 220 218 98 98 220 
218 98 98 220 0 0 0 0 0 0 0 0 0 0 0 0 218 98 98 220 0 0 0 0 0 0 0 0 0 0 0 0 218 98 98 220 218 98 98 220 
218 98 98 220 0 0 0 0 0 0 0 0 0 0 0 0 218 98 98 220 0 0 0 0 0 0 0 0 0 0 0 0 218 98 98 220 218 98 98 220 
218 98 98 220 0 0 0 0 0 0 0 0 0 0 0 0 258 259 259 260 0 0 0 0 0 0 0 0 0 0 0 0 218 98 98 220 218 98 98 220 
218 98 98 220 0 0 0 0 178 179 179 180 0 0 0 0 0 0 0 0 0 0 0 0 0 0 0 0 0 0 0 0 218 98 98 220 218 98 98 220 
258 259 259 260 0 0 0 0 218 98 98 220 0 0 0 0 0 0 0 0 0 0 0 0 0 0 0 0 0 0 0 0 218 98 98 220 218 98 98 220 
0 0 0 0 0 0 0 0 218 98 98 220 0 0 0 0 178 179 179 180 0 0 0 0 0 0 0 0 0 0 0 0 218 98 98 220 218 98 98 220 
0 0 0 0 0 0 0 0 218 98 98 220 0 0 0 0 258 259 259 260 0 0 0 0 0 0 0 0 0 0 0 0 218 98 98 220 218 98 98 220 
0 0 0 0 0 0 0 0 218 98 98 220 0 0 0 0 0 0 0 0 0 0 0 0 178 179 179 180 0 0 0 0 218 98 98 220 218 98 98 220 
0 0 0 0 0 0 0 0 218 98 98 220 0 0 0 0 0 0 0 0 0 0 0 0 258 259 259 260 0 0 0 0 218 98 98 220 218 98 98 220 
0 0 0 0 0 0 0 0 218 98 98 220 0 0 0 0 0 0 0 0 0 0 0 0 0 0 0 0 0 0 0 0 218 98 98 220 258 259 259 260 
0 0 0 0 0 0 0 0 218 98 98 220 0 0 0 0 0 0 0 0 0 0 0 0 0 0 0 0 0 0 0 0 258 259 259 260 0 0 0 0 
0 0 0 0 0 0 0 0 218 98 98 220 0 0 0 0 0 0 0 0 0 0 0 0 178 179 179 180 0 0 0 0 0 0 0 0 0 0 0 0 
0 0 0 0 0 0 0 0 218 98 98 220 0 0 0 0 0 0 0 0 0 0 0 0 218 98 98 220 0 0 0 0 0 0 0 0 0 0 0 0 
0 0 0 0 0 0 0 0 218 98 98 220 0 0 0 0 0 0 0 0 0 0 0 0 218 98 98 220 0 0 0 0 0 0 0 0 0 0 0 0 
0 0 0 0 178 179 179 180 218 98 98 220 0 0 0 0 0 0 0 0 0 0 0 0 218 98 98 220 0 0 0 0 0 0 0 0 0 0 0 0 
178 179 179 180 218 98 98 220 218 98 98 220 0 0 0 0 0 0 0 0 0 0 0 0 218 98 98 220 178 179 179 180 0 0 0 0 0 0 0 0 
218 98 98 220 218 98 98 220 218 98 98 220 0 0 0 0 0 0 0 0 0 0 0 0 218 98 98 220 218 98 98 220 178 179 179 180 0 0 0 0 
218 98 98 220 218 98 98 220 218 98 98 220 0 0 0 0 0 0 0 0 0 0 0 0 218 98 98 220 218 98 98 220 218 98 98 220 178 179 179 180 
218 98 98 220 218 98 98 220 218 98 98 220 178 179 179 180 0 0 0 0 178 179 179 180 218 98 98 220 218 98 98 220 218 98 98 220 218 98 98 220 
218 98 98 220 218 98 98 220 218 98 98 220 218 98 98 220 178 179 179 180 218 98 98 220 218 98 98 220 218 98 98 220 218 98 98 220 218 98 98 220 
218 98 98 220 218 98 98 220 218 98 98 220 218 98 98 220 218 98 98 220 218 98 98 220 218 98 98 220 218 98 98 220 218 98 98 220 218 98 98 220 
6
33 22 10 1
12 22 11 96
20 6 11 96
30 17 1 2 8 0 0 320 240
12 11 1 3 8 0 0 320 240
9 4 10 0
