98 98 98 98 98 98 98 220 218 98 220 740 740 740 740 740 740 218 98 220 0 0 0 0 0 0 218 98 98 98 220 218 98 220 740 740 740 740 740 740 
98 98 98 98 98 98 98 220 218 98 220 740 740 740 740 740 740 218 98 220 0 0 0 0 0 0 218 98 98 98 220 218 98 220 740 740 740 740 740 740 
259 259 259 259 259 259 259 260 218 98 220 740 740 740 740 740 740 218 98 220 0 0 0 0 0 0 258 259 259 259 260 218 98 139 179 179 179 179 179 179 
0 0 0 0 0 0 0 0 218 98 220 740 740 740 740 740 740 218 98 220 0 0 0 0 0 0 7 7 7 7 7 218 98 98 98 98 98 98 98 98 
0 0 0 0 0 0 0 0 218 98 220 740 740 740 740 740 740 218 98 220 0 0 0 0 0 0 0 0 0 0 0 258 259 259 259 259 259 259 259 259 
0 0 0 0 0 0 0 0 218 98 220 740 740 740 740 740 740 218 98 220 0 0 0 0 0 0 0 0 0 0 0 0 0 0 0 0 0 178 179 179 
0 0 0 0 0 0 0 0 218 98 220 740 740 740 740 740 740 218 98 220 0 0 0 0 0 0 0 0 0 0 0 0 0 0 0 0 0 218 98 98 
179 179 179 180 0 0 0 0 218 98 139 179 179 179 179 179 179 140 98 220 0 0 0 0 0 0 0 0 0 0 0 0 0 0 0 0 0 218 98 98 
98 98 98 220 0 0 0 0 218 98 98 98 98 98 98 98 98 98 98 220 0 0 0 0 0 0 0 0 0 0 0 0 0 0 0 0 0 218 98 98 
259 100 98 220 0 0 0 0 258 259 259 259 259 259 259 259 259 259 259 260 0 0 0 0 0 0 0 0 0 0 0 0 740 740 0 0 0 218 98 98 
740 218 98 220 0 0 0 0 178 180 0 0 0 0 0 0 0 0 0 0 0 0 0 0 0 0 0 0 0 0 0 0 0 0 0 0 0 218 98 98 
740 218 98 220 0 0 0 0 218 220 0 0 0 0 0 0 0 0 0 0 0 0 0 0 0 0 0 0 0 0 0 0 0 0 0 0 0 218 98 98 
740 218 98 220 0 0 0 0 218 220 0 0 0 0 0 0 0 0 0 0 0 0 0 0 0 0 0 0 0 0 0 0 0 0 0 0 0 218 98 98 
740 218 98 220 0 0 0 0 218 220 0 0 0 0 0 178 179 179 180 740 740 6 6 740 740 6 6 740 740 6 6 178 179 179 179 179 180 218 98 98 
740 218 98 220 0 0 0 0 218 220 0 0 0 0 0 258 259 259 260 7 7 740 740 7 7 740 740 7 7 740 740 258 259 259 259 259 260 218 98 98 
740 218 98 220 0 0 0 0 218 220 0 0 0 0 0 0 0 0 0 0 0 0 0 0 0 0 0 0 0 0 0 0 0 0 0 0 0 218 98 98 
740 218 98 220 0 0 0 0 218 220 0 0 0 0 0 0 0 0 0 0 0 0 0 0 0 0 0 0 0 0 0 0 0 0 0 0 0 218 98 98 
740 218 98 220 0 0 0 0 218 220 0 0 0 0 0 0 0 0 0 0 0 0 0 0 0 0 0 0 0 0 0 0 0 0 0 0 0 218 98 98 
740 218 98 220 0 0 0 0 218 220 0 0 0 0 0 0 0 0 0 0 0 0 0 0 0 0 0 0 0 0 0 0 0 0 0 0 0 218 98 98 
740 218 98 220 0 0 0 0 258 260 0 0 0 0 0 0 0 0 0 0 0 0 0 0 0 0 0 0 0 0 0 0 740 740 0 0 0 218 98 98 
740 218 98 220 0 0 0 0 0 0 0 0 0 0 0 0 0 0 0 0 0 0 0 0 0 0 0 0 0 0 0 0 0 0 0 0 0 218 98 98 
740 218 98 220 0 0 0 0 0 0 0 0 0 0 0 0 0 0 0 0 0 0 0 0 0 0 0 0 0 0 0 0 0 0 0 0 0 218 98 98 
740 218 98 220 0 0 0 0 0 0 0 0 0 0 0 0 0 0 0 0 0 0 0 0 0 0 0 0 0 0 0 0 0 0 0 0 0 218 98 98 
740 218 98 220 0 0 0 0 0 0 0 0 0 0 0 0 0 0 0 0 0 0 0 0 0 0 0 0 0 0 0 0 0 0 0 0 0 258 259 259 
740 218 98 220 178 179 179 179 179 179 179 180 0 0 0 0 0 740 0 0 0 0 0 0 740 0 0 0 0 0 178 179 179 179 179 179 179 179 179 179 
740 218 98 220 218 98 98 98 98 98 98 220 6 6 6 6 6 740 6 6 6 6 6 6 740 6 6 6 6 6 218 98 98 98 98 98 98 98 98 98 
740 218 98 220 218 98 99 259 259 100 98 220 178 179 179 179 179 179 179 179 179 179 179 179 179 179 179 179 179 180 218 98 99 259 259 259 259 259 259 259 
740 218 98 220 218 98 220 740 740 218 98 220 218 98 98 98 98 98 98 98 98 98 98 98 98 98 98 98 98 220 218 98 220 740 740 740 740 740 740 740 
740 218 98 220 218 98 220 740 740 218 98 220 218 98 98 98 98 98 98 98 98 98 98 98 98 98 98 98 98 220 218 98 220 740 740 740 740 740 740 740 
4
5 22 10 1
10 19 11 176
16 11 10 1
20 9 11 96
