98 98 220 218 98 98 98 98 98 98 98 98 98 220 218 98 220 218 98 98 98 98 98 98 98 98 98 98 220 218 98 98 98 98 98 98 98 98 98 98 
98 98 220 258 259 259 259 259 259 259 259 259 259 260 218 98 220 258 259 259 259 259 259 259 259 259 259 259 260 218 98 98 98 98 98 98 98 98 98 98 
259 259 260 7 7 7 7 7 7 7 7 7 7 7 258 259 260 7 7 7 7 7 7 7 7 7 7 7 7 258 259 259 259 259 259 259 259 259 259 259 
179 180 49 0 0 0 0 0 0 0 0 0 0 0 50 740 49 0 0 0 0 0 0 0 0 0 0 0 0 50 178 179 179 179 179 179 179 179 179 179 
98 220 49 0 0 0 0 0 0 0 0 0 0 0 50 740 49 0 0 0 0 0 0 0 0 0 0 0 0 50 218 98 98 98 98 98 98 98 98 98 
98 220 49 0 0 0 0 0 0 0 0 0 0 0 50 740 49 0 0 0 0 0 0 0 0 0 0 0 0 50 218 98 99 259 259 259 259 259 259 259 
98 220 49 0 0 0 0 0 0 0 0 0 0 0 50 740 49 0 0 0 0 0 0 0 0 0 0 0 0 50 218 98 220 740 740 740 740 740 740 740 
259 260 49 0 0 0 0 0 0 0 0 0 0 0 50 740 49 0 0 0 0 0 0 0 0 0 0 0 0 50 218 98 220 740 740 740 740 740 740 740 
7 7 0 0 0 0 0 0 0 0 0 0 0 0 50 740 49 0 0 0 0 0 0 0 0 0 0 0 0 50 218 98 220 740 740 740 740 740 740 740 
0 0 0 0 0 0 0 0 0 0 0 0 0 0 50 740 49 0 0 0 0 0 0 0 0 0 0 0 0 50 218 98 220 740 740 740 740 740 740 740 
0 0 0 0 0 0 0 0 0 0 0 0 0 0 50 740 49 0 0 0 0 0 0 0 0 0 0 0 0 50 218 98 139 179 179 179 179 179 179 179 
0 0 0 0 0 0 0 0 0 0 0 0 0 0 50 740 49 0 0 0 0 0 0 0 0 0 0 0 0 50 218 98 98 98 98 98 98 98 98 98 
0 0 0 0 0 0 0 0 0 0 0 0 0 0 50 740 49 0 0 0 0 0 0 0 0 0 0 0 0 50 258 259 259 259 259 259 259 259 259 259 
0 0 0 0 0 0 0 0 0 0 0 0 0 0 50 740 49 0 0 0 0 0 0 6 0 0 0 0 0 0 7 0 0 0 0 0 0 0 0 0 
0 0 0 0 0 0 0 0 0 0 0 0 0 0 50 740 49 0 0 0 0 0 50 740 49 0 0 0 0 0 0 0 0 0 0 0 0 0 0 0 
0 0 0 0 0 0 0 0 6 0 0 0 0 0 0 7 0 0 0 0 0 0 50 740 49 0 0 0 0 0 0 0 0 0 0 0 0 0 0 0 
179 179 179 179 179 179 179 179 180 49 0 0 0 0 0 0 0 0 0 0 0 0 50 740 49 0 0 0 0 0 0 0 0 0 0 0 0 0 0 0 
98 98 98 98 98 98 98 98 220 49 0 0 0 0 0 0 0 0 0 0 0 0 50 740 49 0 0 0 0 0 0 0 0 0 0 0 0 0 0 0 
259 259 259 259 259 259 100 98 220 49 0 0 0 0 0 0 0 0 0 0 0 0 50 740 49 0 0 0 0 0 0 0 0 0 0 0 0 0 0 0 
740 740 740 740 740 740 218 98 220 49 0 0 0 0 0 0 0 0 0 0 0 0 50 740 49 0 0 0 0 0 0 0 0 0 0 0 0 0 0 0 
740 740 740 740 740 740 218 98 220 49 0 0 0 0 0 0 0 0 0 0 0 0 50 740 49 0 0 0 0 0 0 0 0 0 0 0 0 0 6 6 
740 740 740 740 740 740 218 98 220 49 0 0 0 0 0 0 0 0 0 0 0 0 50 740 49 0 0 0 0 0 0 0 0 0 0 0 0 50 178 179 
740 740 740 740 740 740 218 98 220 49 0 0 0 0 0 0 0 0 0 0 0 0 50 740 49 0 0 0 0 0 0 0 0 0 0 0 0 50 218 98 
740 740 740 740 740 740 218 98 220 49 0 0 0 0 0 0 0 0 0 0 0 0 50 740 49 0 0 0 0 0 0 0 0 0 0 0 0 50 218 98 
179 179 179 179 179 179 140 98 220 49 0 0 0 0 0 0 0 0 0 0 0 0 50 740 49 0 0 0 0 0 0 0 0 0 0 0 0 50 218 98 
98 98 98 98 98 98 98 98 220 49 0 0 0 0 0 0 0 0 0 0 0 0 50 740 49 0 0 0 0 0 0 0 0 0 0 0 0 50 218 98 
259 259 259 259 259 259 259 259 260 49 0 0 0 0 0 0 0 0 0 0 0 0 50 740 49 0 0 0 0 0 0 0 0 0 0 0 0 50 258 259 
179 179 179 179 179 179 179 179 179 180 6 6 6 6 6 6 6 6 6 6 6 6 178 179 180 6 6 6 6 6 6 6 6 6 6 6 6 178 179 179 
98 98 98 98 98 98 98 98 98 220 178 179 179 179 179 179 179 179 179 179 179 180 218 98 220 178 179 179 179 179 179 179 179 179 179 179 180 218 98 98 
6
2 14 10 1
8 3 12 96
30 14 12 104
36 13 10 0
23 3 12 80
15 16 12 88
