0 0 0 0 0 0 0 0 0 0 0 0 0 0 0 0 218 98 220 740 740 740 740 740 740 740 740 740 740 740 740 740 740 740 740 740 740 740 740 740 
0 0 0 0 0 0 0 0 0 0 0 0 0 0 0 0 218 98 139 179 179 179 179 179 179 179 179 179 179 179 179 179 179 179 179 179 179 179 179 179 
0 0 0 0 0 0 0 0 0 0 0 0 0 0 0 0 218 98 98 98 98 98 98 98 98 98 98 98 98 98 98 98 98 98 98 98 98 98 98 98 
0 0 0 0 0 0 0 0 0 0 0 0 0 0 0 0 258 259 259 259 259 259 259 259 259 259 259 259 259 259 259 259 259 259 259 259 259 259 259 259 
0 0 0 0 0 0 0 0 0 0 0 0 0 0 0 0 0 0 0 0 0 0 0 0 0 0 0 0 0 0 0 0 0 0 0 0 0 0 0 0 
0 0 0 0 0 0 0 0 0 0 0 0 0 0 0 0 0 0 0 0 0 0 0 0 0 0 0 0 0 0 0 0 0 0 0 0 0 0 0 0 
0 0 0 0 0 0 0 0 0 0 0 0 0 0 0 0 0 0 0 0 0 0 0 0 0 0 0 0 0 0 0 0 0 0 0 0 0 0 0 0 
0 0 0 0 0 0 0 0 0 0 0 0 0 0 0 0 0 0 0 0 0 0 0 0 0 0 0 0 0 0 0 0 0 0 0 0 0 0 0 0 
0 0 0 0 0 0 0 0 0 0 0 0 0 0 0 0 0 0 0 0 0 0 0 0 0 0 0 0 0 0 0 178 179 179 179 179 179 179 179 179 
0 0 0 0 0 0 0 0 0 0 0 0 0 0 0 0 0 0 0 0 0 0 0 0 0 0 0 0 0 0 0 218 98 98 98 98 98 98 98 98 
0 0 0 0 0 0 0 0 0 0 0 0 0 0 0 0 0 0 0 0 0 0 0 0 0 0 0 0 0 0 0 218 98 99 259 259 259 259 259 259 
0 0 0 0 0 0 0 0 0 0 0 0 0 0 0 0 0 0 0 0 0 0 0 0 0 0 0 0 0 0 0 218 98 220 740 740 740 740 740 740 
0 0 0 0 0 0 0 0 0 0 0 0 0 0 0 0 0 0 0 0 0 0 0 0 0 0 0 0 0 0 0 218 98 220 740 740 740 740 740 740 
0 0 0 0 0 0 0 0 0 0 0 0 0 0 0 0 0 0 0 0 0 0 0 0 0 0 0 0 0 0 0 218 98 220 740 740 740 740 740 740 
0 0 0 0 0 0 0 0 0 0 0 0 0 0 0 0 0 0 0 0 0 0 0 0 0 0 0 0 0 0 0 218 98 220 740 740 740 740 740 740 
0 0 0 0 0 0 0 0 0 0 0 0 0 0 0 0 0 0 0 0 0 0 0 0 0 0 0 0 0 0 0 218 98 220 740 740 740 740 740 740 
0 0 0 0 0 0 0 0 0 0 0 0 0 0 0 0 0 0 0 0 0 0 0 0 0 0 0 0 0 0 0 218 98 220 740 740 740 740 740 740 
0 0 0 0 0 0 0 0 0 0 0 0 0 0 0 0 0 0 0 0 0 0 0 0 0 0 0 0 0 0 0 218 98 220 740 740 740 740 740 740 
0 0 0 0 0 0 0 0 0 0 0 0 0 0 0 0 0 0 0 0 0 0 0 0 0 0 0 0 0 0 0 218 98 220 740 740 740 740 740 740 
0 0 0 0 0 0 0 0 0 0 0 0 0 0 0 0 0 0 0 0 0 0 0 0 0 0 0 0 0 0 0 218 98 220 740 740 740 740 740 740 
0 0 0 0 0 0 0 0 0 0 0 0 0 0 0 0 0 0 0 0 0 0 0 0 0 0 0 0 0 0 0 218 98 220 740 740 740 740 740 740 
0 0 0 0 0 0 0 0 0 0 0 0 0 0 0 0 0 0 0 0 0 0 0 0 0 0 0 0 0 0 0 218 98 220 740 740 740 740 740 740 
0 0 0 0 0 0 0 0 0 0 0 0 0 0 0 0 0 0 0 0 0 0 0 0 0 0 0 0 0 0 0 218 98 220 740 740 740 740 740 740 
0 0 0 0 0 0 0 0 0 0 0 0 0 0 0 0 0 0 0 0 0 0 0 0 0 0 0 0 178 179 180 218 98 220 740 740 740 740 740 740 
0 0 0 0 0 0 0 0 0 0 0 0 0 0 0 0 0 0 0 0 0 0 0 0 0 178 179 180 218 98 220 218 98 220 740 740 740 740 740 740 
0 0 0 0 0 0 0 0 0 0 0 0 0 0 0 0 0 0 0 0 0 0 178 179 180 218 98 220 218 98 220 218 98 220 740 740 740 740 740 740 
0 0 0 0 0 0 0 0 0 0 0 0 0 0 0 0 0 0 0 178 179 180 218 98 220 218 98 220 218 98 220 218 98 220 740 740 740 740 740 740 
0 0 0 0 0 0 0 0 0 0 0 0 0 0 0 0 178 179 180 218 98 220 218 98 220 218 98 220 218 98 220 218 98 220 740 740 740 740 740 740 
0 0 0 0 0 0 0 0 0 0 0 0 0 0 0 0 218 98 220 218 98 220 218 98 220 218 98 220 218 98 220 218 98 220 740 740 740 740 740 740 
1
33 4 10 0
