98 98 98 98 98 220 0 0 218 220 0 0 218 98 220 0 0 0 0 218 220 0 0 0 0 218 98 220 0 0 218 220 0 0 218 98 220 740 740 740 
98 98 98 98 98 220 0 0 218 220 0 0 218 98 220 0 0 0 0 218 220 0 0 0 0 218 98 220 0 0 218 220 0 0 218 98 220 740 740 740 
98 98 98 98 98 220 0 0 218 220 0 0 218 98 220 0 0 0 0 218 220 0 0 0 0 258 259 260 0 0 218 220 0 0 218 98 220 740 740 740 
259 259 259 259 259 260 0 0 218 220 0 0 218 98 220 0 0 0 0 218 220 0 0 0 0 0 0 0 0 0 218 220 0 0 218 98 220 740 740 740 
0 0 0 0 0 0 0 0 218 220 0 0 218 98 220 0 0 0 0 218 220 0 0 0 0 0 0 0 0 0 218 220 0 0 218 98 220 740 740 740 
0 0 0 0 0 0 0 0 218 220 0 0 218 98 220 0 0 0 0 218 220 0 0 0 0 0 0 0 0 0 218 220 0 0 218 98 220 740 740 740 
0 0 0 0 0 0 0 0 218 220 0 0 218 98 220 0 0 0 0 218 220 0 0 0 0 0 0 0 0 0 218 220 0 0 218 98 220 740 740 740 
0 0 0 0 0 0 0 0 258 260 0 0 218 98 220 0 0 0 0 218 220 0 0 0 0 0 0 0 0 0 258 260 0 0 218 98 220 740 740 740 
179 179 179 179 179 179 179 179 179 180 0 0 218 98 220 0 0 0 0 258 260 0 0 0 0 178 179 179 179 179 179 180 0 0 218 98 220 740 740 740 
98 98 98 98 98 98 98 98 98 220 0 0 218 98 220 0 0 0 0 7 7 0 0 0 0 218 98 98 98 98 98 220 0 0 218 98 220 740 740 740 
98 98 98 98 98 98 98 98 98 220 0 0 218 98 220 0 0 0 0 0 0 0 0 0 0 218 98 98 98 98 98 220 0 0 218 98 220 740 740 740 
259 259 259 259 259 259 259 259 259 260 0 0 218 98 220 0 0 0 0 0 0 0 0 0 0 258 259 259 259 259 259 260 0 0 218 98 220 740 740 740 
179 179 179 179 179 180 0 0 0 0 0 0 218 98 220 0 0 0 0 0 0 0 0 0 0 178 179 180 0 0 0 0 0 0 218 98 220 740 740 740 
98 98 98 98 98 220 0 0 0 0 0 0 218 98 220 0 0 0 0 0 0 0 0 0 0 218 98 220 0 0 0 0 0 0 218 98 220 740 740 740 
259 259 259 100 98 220 0 0 0 0 0 0 218 98 220 0 0 0 0 0 0 0 0 0 0 218 98 220 0 0 0 0 0 0 218 98 139 179 179 179 
740 740 740 218 98 220 0 0 0 0 0 0 218 98 220 0 0 0 0 0 0 0 0 0 0 218 98 220 0 0 0 0 0 0 218 98 98 98 98 98 
740 740 740 218 98 220 0 0 0 0 0 0 258 259 260 0 0 0 0 0 0 0 0 0 0 218 98 220 0 0 0 0 0 0 258 259 259 259 259 259 
740 740 740 218 98 220 0 0 178 179 179 179 179 179 180 0 0 0 0 0 0 0 0 0 0 218 98 220 0 0 178 179 179 179 179 179 179 179 179 179 
740 740 740 218 98 220 0 0 218 98 98 98 98 98 220 0 0 0 0 0 0 0 0 0 0 218 98 220 0 0 218 98 98 98 98 98 98 98 98 98 
740 740 740 218 98 220 0 0 218 98 98 98 98 98 220 0 0 0 0 6 6 0 0 0 0 218 98 220 0 0 218 98 98 98 98 98 98 98 98 98 
740 740 740 218 98 220 0 0 258 259 259 259 259 259 260 0 0 0 0 178 180 0 0 0 0 218 98 220 0 0 258 259 259 259 259 259 259 259 259 259 
740 740 740 218 98 220 0 0 178 180 0 0 0 0 0 0 0 0 0 218 220 0 0 0 0 218 98 220 0 0 178 180 0 0 0 0 0 0 0 0 
740 740 740 218 98 220 0 0 218 220 0 0 0 0 0 0 0 0 0 218 220 0 0 0 0 218 98 220 0 0 218 220 0 0 0 0 0 0 0 0 
740 740 740 218 98 220 0 0 218 220 0 0 0 0 0 0 0 0 0 218 220 0 0 0 0 218 98 220 0 0 218 220 0 0 0 0 0 0 0 0 
740 740 740 218 98 220 0 0 218 220 0 0 0 0 0 0 0 0 0 218 220 0 0 0 0 218 98 220 0 0 218 220 0 0 0 0 0 0 0 0 
740 740 740 218 98 220 0 0 218 220 0 0 0 0 0 0 0 0 0 218 220 0 0 0 0 218 98 220 0 0 218 220 0 0 178 179 179 179 179 179 
740 740 740 218 98 220 0 0 218 220 0 0 178 179 180 0 0 0 0 218 220 0 0 0 0 218 98 220 0 0 218 220 0 0 218 98 98 98 98 98 
740 740 740 218 98 220 0 0 218 220 0 0 218 98 220 0 0 0 0 218 220 0 0 0 0 218 98 220 0 0 218 220 0 0 218 98 98 98 98 98 
740 740 740 218 98 220 0 0 218 220 0 0 218 98 220 0 0 0 0 218 220 0 0 0 0 218 98 220 0 0 218 220 0 0 218 98 98 98 98 98 
1
15 14 11 80
