0 0 0 218 98 98 220 0 0 0 0 0 0 0 218 98 98 220 0 0 0 0 0 0 0 218 98 98 220 0 0 0 0 0 0 0 218 98 220 740 
0 0 0 258 259 259 260 0 0 0 0 0 0 0 258 259 259 260 0 0 0 0 0 0 0 258 259 259 260 0 0 0 0 0 0 0 218 98 220 740 
0 0 0 7 7 7 7 0 0 0 0 0 0 0 7 7 7 7 0 0 0 0 0 0 0 7 7 7 7 0 0 0 0 0 0 0 218 98 220 740 
0 0 0 0 0 0 0 0 0 0 0 0 0 0 0 0 0 0 0 0 0 0 0 0 0 0 0 0 0 0 0 0 0 0 0 0 218 98 220 740 
0 0 0 0 0 0 0 0 0 0 0 0 0 0 0 0 0 0 0 0 0 0 0 0 0 0 0 0 0 0 0 0 0 0 0 0 218 98 220 740 
0 0 0 0 0 0 0 0 0 0 0 0 0 0 0 0 0 0 0 0 0 0 0 0 0 0 0 0 0 0 0 0 0 0 0 0 218 98 220 740 
0 0 0 0 0 0 0 0 0 0 0 0 0 0 0 0 0 0 0 0 0 0 0 0 0 0 0 0 0 0 0 0 0 0 0 0 218 98 220 740 
0 0 0 0 0 0 0 0 0 0 0 0 0 0 0 0 0 0 0 0 0 0 0 0 0 0 0 0 0 0 0 0 0 0 0 0 218 98 220 740 
0 0 0 0 0 0 0 0 0 0 0 0 0 0 0 0 0 0 0 0 0 0 0 0 0 0 0 0 0 0 0 0 0 0 0 0 218 98 220 740 
0 0 0 0 0 0 0 0 0 0 0 0 0 0 0 0 0 0 0 0 0 0 0 0 0 0 0 0 0 0 0 0 0 0 0 0 218 98 220 740 
0 0 0 0 0 0 0 0 0 0 0 0 0 0 0 0 0 0 0 0 0 0 0 0 0 0 0 0 0 0 0 0 0 0 0 0 218 98 220 740 
0 0 0 0 0 0 0 0 0 0 0 0 0 0 0 0 0 0 0 0 0 0 0 0 0 0 0 0 0 0 0 0 0 0 0 0 218 98 220 740 
0 0 0 0 0 0 0 0 0 0 0 0 0 0 0 0 0 0 0 0 0 0 0 0 0 0 0 0 0 0 0 0 0 0 0 0 218 98 220 740 
0 0 0 0 178 180 0 0 0 0 0 0 0 0 0 0 0 0 0 0 0 0 0 0 0 0 0 0 0 178 179 179 179 179 179 180 218 98 220 740 
0 0 0 0 218 220 0 0 0 0 0 0 0 0 0 0 0 0 0 0 0 0 0 0 0 0 0 0 0 218 98 98 98 98 98 220 218 98 220 740 
0 0 0 0 258 260 0 0 0 0 0 0 0 0 0 0 0 0 0 0 0 0 0 0 0 0 0 0 0 258 259 259 259 259 259 260 218 98 220 740 
0 0 0 0 0 0 0 0 0 0 0 0 0 0 0 0 0 0 0 0 0 0 0 0 0 0 0 0 0 0 0 0 0 0 0 0 218 98 220 740 
0 0 0 0 0 0 0 0 0 0 0 0 0 0 0 0 0 0 0 0 0 0 0 0 0 0 0 0 0 0 0 0 0 0 0 0 218 98 220 740 
0 0 0 0 0 0 0 0 0 0 0 0 0 0 0 0 0 0 0 0 0 0 0 0 0 0 0 0 0 0 0 0 0 0 0 0 218 98 220 740 
0 0 0 0 0 0 0 0 0 0 0 0 0 0 0 0 0 0 0 0 0 0 0 0 0 0 0 0 0 0 0 0 0 0 0 0 218 98 220 740 
0 0 0 0 0 0 0 0 0 0 0 0 0 0 0 0 0 0 0 0 0 0 0 0 0 0 0 0 0 0 0 0 0 0 0 0 218 98 220 740 
0 0 0 0 0 0 0 0 0 0 0 0 0 0 0 0 0 0 0 0 0 0 0 0 0 0 0 0 0 0 0 0 0 0 0 0 218 98 220 740 
0 0 0 0 0 0 0 0 0 0 0 0 0 0 0 0 0 0 0 0 0 0 0 0 0 0 0 0 0 0 0 0 0 0 0 0 218 98 220 740 
0 0 0 0 0 0 0 0 0 0 0 0 0 0 0 0 0 0 0 0 0 0 0 0 0 0 0 0 0 0 0 0 0 0 0 0 218 98 220 740 
0 0 0 0 0 0 0 0 0 0 0 0 0 0 0 0 0 0 0 0 0 0 0 0 0 0 0 0 0 0 0 0 0 0 0 0 218 98 220 740 
0 0 0 0 0 0 0 0 0 0 0 0 0 0 0 0 0 0 0 0 0 0 0 0 0 0 0 0 0 0 0 0 0 0 0 0 218 98 220 740 
0 0 0 6 6 6 6 0 0 0 0 0 0 0 6 6 6 6 0 0 0 0 0 0 0 6 6 6 6 0 0 0 0 0 0 0 218 98 220 740 
0 0 0 178 179 179 180 0 0 0 0 0 0 0 178 179 179 180 0 0 0 0 0 0 0 178 179 179 180 0 0 0 0 0 0 0 218 98 220 740 
0 0 0 218 98 98 220 0 0 0 0 0 0 0 218 98 98 220 0 0 0 0 0 0 0 218 98 98 220 0 0 0 0 0 0 0 218 98 220 740 
6
0 14 11 32
6 14 11 184
4 11 10 1
4 16 10 0
32 11 10 1
32 16 10 0
