98 98 98 98 98 98 98 98 98 98 98 98 98 98 98 98 98 98 98 98 220 0 0 0 0 0 0 0 218 220 218 98 220 740 740 740 740 740 740 740 
98 98 98 98 98 98 98 98 98 98 98 98 98 98 98 98 98 98 98 98 220 0 0 0 0 0 0 0 218 220 218 98 139 179 179 179 179 179 179 179 
98 98 98 98 98 98 98 98 98 98 98 98 98 98 98 98 98 98 98 98 220 0 0 0 0 0 0 0 218 220 218 98 98 98 98 98 98 98 98 98 
259 259 259 259 259 259 259 259 259 259 259 259 259 259 259 259 259 259 259 259 260 0 0 0 0 0 0 0 218 220 258 259 259 259 259 259 259 259 259 259 
0 0 0 0 0 178 180 0 0 0 0 0 0 0 0 0 0 0 0 0 0 0 0 0 0 0 0 0 218 220 0 0 0 0 0 0 0 0 0 0 
0 0 0 0 0 218 220 0 0 0 0 0 0 0 0 0 0 0 0 0 0 0 0 0 0 0 0 0 218 220 0 0 0 0 0 0 0 0 0 0 
0 0 0 0 0 218 220 0 0 0 0 0 0 0 0 0 0 0 0 0 0 0 0 0 0 0 0 0 218 220 0 0 0 0 0 0 0 0 0 0 
0 0 0 0 0 218 220 0 0 0 0 0 0 0 0 0 0 0 0 0 0 0 0 0 0 0 0 0 218 220 0 0 0 0 0 0 0 0 0 0 
6 6 0 0 0 218 220 0 0 0 0 0 0 0 0 0 0 0 0 0 0 0 0 0 0 0 0 0 258 260 0 0 0 6 6 6 6 6 6 6 
179 180 0 0 0 218 220 0 0 0 178 179 179 179 179 179 179 179 179 179 180 178 179 179 179 179 179 179 179 180 0 0 0 178 179 179 179 179 179 179 
98 220 0 0 0 218 220 0 0 0 218 98 98 98 98 98 98 98 98 98 220 218 98 98 98 98 98 98 98 220 0 0 0 218 98 98 98 98 98 98 
98 220 0 0 0 218 220 0 0 0 218 98 98 98 98 98 98 98 98 98 220 258 259 259 259 259 259 259 259 260 0 0 0 218 98 98 98 98 98 98 
259 260 0 0 0 218 220 0 0 0 218 98 98 98 98 98 98 98 98 98 220 0 0 0 0 0 0 0 178 180 0 0 0 258 259 259 259 259 259 259 
0 0 0 0 0 218 220 0 0 0 218 98 98 98 98 98 98 98 98 98 220 0 0 0 0 0 0 0 218 220 0 0 0 178 180 0 0 0 0 0 
0 0 0 0 0 218 220 0 0 0 258 259 259 259 259 259 259 259 259 259 260 0 0 0 0 0 0 0 258 260 0 0 0 218 220 0 0 0 0 0 
0 0 0 0 0 218 220 0 0 0 0 0 0 0 0 0 0 0 0 0 0 0 0 0 0 0 0 0 0 0 0 0 0 218 220 0 0 0 0 0 
0 0 0 0 0 218 220 0 0 0 0 0 0 0 0 0 0 0 0 0 0 0 0 0 0 0 0 0 0 0 0 0 0 218 220 0 0 0 0 0 
0 0 0 0 0 218 220 0 0 0 0 0 0 0 0 0 0 0 0 0 0 0 0 0 0 0 0 0 0 0 0 0 0 218 220 0 0 0 0 0 
179 179 179 179 180 218 220 0 0 0 0 0 0 0 0 0 0 0 0 0 0 0 0 0 0 0 0 0 0 0 0 0 0 218 220 0 0 0 178 179 
98 98 98 98 220 218 220 0 0 0 0 0 0 0 0 0 0 0 0 0 0 0 0 0 0 0 0 0 0 0 0 0 0 218 220 0 0 0 218 98 
259 259 259 259 260 258 260 0 0 0 0 0 0 0 0 0 0 0 0 0 0 0 0 0 0 0 0 0 0 0 0 0 0 218 220 0 0 0 258 259 
0 0 0 0 0 178 179 179 179 179 180 0 0 0 0 0 0 0 178 179 179 179 179 179 179 179 179 179 179 179 179 179 180 218 220 0 0 0 0 0 
0 0 0 0 0 218 98 98 98 98 220 0 0 0 0 0 0 0 218 98 98 98 98 98 98 98 98 98 98 98 98 98 220 218 220 0 0 0 0 0 
0 0 0 0 0 218 98 98 98 98 220 0 0 0 0 0 0 0 218 98 99 259 259 259 259 259 259 259 259 259 100 98 220 218 220 0 0 0 0 0 
0 0 0 0 0 218 98 98 98 98 220 178 179 179 179 179 179 180 218 98 220 740 740 740 740 740 740 740 740 740 218 98 220 218 220 0 0 0 0 0 
0 0 0 0 0 218 98 98 98 98 220 218 98 98 98 98 98 220 218 98 220 740 740 740 740 740 740 740 740 740 218 98 220 258 260 0 0 0 0 0 
179 180 0 0 0 218 98 98 98 98 220 218 98 98 98 98 98 220 218 98 220 740 740 740 740 740 740 740 740 740 218 98 220 178 179 179 179 179 179 179 
98 220 0 0 0 218 98 98 98 98 220 218 98 98 98 98 98 220 218 98 220 740 740 740 740 740 740 740 740 740 218 98 220 218 98 98 98 98 98 98 
98 220 0 0 0 218 98 98 98 98 220 218 98 98 98 98 98 220 218 98 220 740 740 740 740 740 740 740 740 740 218 98 220 218 98 98 98 98 98 98 
8
24 7 10 1
21 12 1 0 5 0 0 320 240
23 13 1 0 5 0 0 320 240
25 14 1 0 5 0 0 320 240
11 22 1 1 5 0 0 320 240
13 21 1 1 5 0 0 320 240
15 20 1 1 5 0 0 320 240
36 13 10 0
