740 740 740 740 740 740 740 740 740 740 740 740 740 740 740 740 0 0 0 0 0 0 0 0 740 740 740 740 740 740 740 740 740 740 740 740 740 740 740 740 
740 740 740 740 740 740 740 740 740 740 740 740 740 740 740 740 0 0 0 0 0 0 0 0 740 740 740 740 740 740 740 740 740 740 740 740 740 740 740 740 
740 740 740 740 740 740 740 740 740 740 740 740 740 740 740 740 0 0 0 0 0 0 0 0 740 740 740 740 740 740 740 740 740 740 740 740 740 740 740 740 
740 740 740 740 740 740 740 740 740 740 740 740 740 740 740 740 0 0 0 0 0 0 0 0 740 740 740 740 740 740 740 740 740 740 740 740 740 740 740 740 
740 740 740 740 740 740 740 740 740 740 740 740 740 740 740 740 0 0 0 0 0 0 0 0 740 740 740 740 740 740 740 740 740 740 740 740 740 740 740 740 
740 740 740 740 740 740 740 740 740 740 740 740 740 740 740 740 740 0 0 0 0 0 0 740 740 740 740 740 740 740 740 740 740 740 740 740 740 740 740 740 
740 740 740 740 740 740 740 740 740 740 740 740 740 740 740 740 740 0 0 0 0 0 0 740 740 740 740 740 740 740 740 740 740 740 740 740 740 740 740 740 
740 740 740 740 740 740 740 740 740 740 740 740 740 740 740 740 740 0 0 0 0 0 0 740 740 740 740 740 740 740 740 740 740 740 740 740 740 740 740 740 
7 7 7 7 7 7 7 7 7 7 7 7 7 7 740 740 740 0 0 0 0 0 0 740 740 740 740 740 740 740 740 740 740 740 740 740 740 740 740 740 
0 0 0 0 0 0 0 0 0 0 0 0 0 0 740 740 740 0 0 0 0 0 0 740 740 740 740 740 740 740 740 740 740 740 740 740 740 740 740 740 
0 0 0 0 0 0 0 0 0 0 0 0 0 0 740 740 740 740 0 0 0 0 740 740 740 740 740 740 740 740 740 740 740 740 740 740 740 740 740 740 
0 0 0 0 0 0 0 0 0 0 0 0 0 0 740 740 740 740 0 0 0 0 740 740 740 740 740 740 740 740 740 740 740 740 740 740 740 740 740 740 
0 0 0 0 0 0 0 0 0 0 0 0 0 0 740 740 740 740 0 0 0 0 740 740 740 740 740 740 740 740 740 740 740 740 740 740 740 740 740 740 
0 0 0 0 0 0 0 0 0 0 0 0 0 0 740 740 740 740 0 0 0 0 740 740 740 740 740 740 740 740 740 740 740 740 740 740 740 740 740 740 
0 0 0 0 0 0 0 0 0 0 0 0 0 0 7 7 7 7 0 0 0 0 740 740 740 740 740 740 740 740 740 740 740 740 740 740 740 740 740 740 
0 0 0 0 0 0 0 0 0 0 0 0 0 0 0 0 0 0 0 0 0 0 740 740 740 740 740 740 740 740 740 740 740 740 740 740 740 740 740 740 
0 0 0 0 0 0 0 0 0 0 0 0 0 0 0 0 0 0 0 0 0 0 740 740 740 740 740 740 740 740 740 740 740 740 740 740 740 740 740 740 
0 0 0 0 0 0 0 0 0 0 0 0 0 0 0 0 0 0 0 0 0 0 740 740 740 740 740 740 740 740 740 740 740 740 740 740 740 740 740 740 
0 0 0 0 0 0 0 0 0 0 0 0 0 0 0 0 0 0 0 0 0 0 740 740 740 740 740 740 740 740 740 740 740 740 740 740 740 740 740 740 
0 0 0 0 0 0 0 0 0 0 0 0 740 740 740 740 740 740 740 740 740 740 740 740 740 740 740 740 740 740 740 740 740 740 740 740 740 740 740 740 
6 6 6 6 0 0 0 0 0 0 0 0 740 740 740 740 740 740 740 740 740 740 740 740 740 740 740 740 740 740 740 740 740 740 740 740 740 740 740 740 
740 740 740 740 6 6 6 6 0 0 0 0 740 740 740 740 740 740 740 740 740 740 740 740 740 740 740 740 740 740 740 740 740 740 740 740 740 740 740 740 
740 740 740 740 740 740 740 740 6 6 6 6 740 740 740 740 740 740 740 740 740 740 740 740 740 740 740 740 740 740 740 740 740 740 740 740 740 740 740 740 
740 740 740 740 740 740 740 740 740 740 740 740 740 740 740 740 740 740 740 740 740 740 740 740 740 740 740 740 740 740 740 740 740 740 740 740 740 740 740 740 
740 740 740 740 740 740 740 740 740 740 740 740 740 740 740 740 740 740 740 740 740 740 740 740 740 740 740 740 740 740 740 740 740 740 740 740 740 740 740 740 
740 740 740 740 740 740 740 740 740 740 740 740 740 740 740 740 740 740 740 740 740 740 740 740 740 740 740 740 740 740 740 740 740 740 740 740 740 740 740 740 
740 740 740 740 740 740 740 740 740 740 740 740 740 740 740 740 740 740 740 740 740 740 740 740 740 740 740 740 740 740 740 740 740 740 740 740 740 740 740 740 
740 740 740 740 740 740 740 740 740 740 740 740 740 740 740 740 740 740 740 740 740 740 740 740 740 740 740 740 740 740 740 740 740 740 740 740 740 740 740 740 
740 740 740 740 740 740 740 740 740 740 740 740 740 740 740 740 740 740 740 740 740 740 740 740 740 740 740 740 740 740 740 740 740 740 740 740 740 740 740 740 
4
0 11 2 4 0 0 0 320 240
4 11 2 4 0 0 0 320 240
8 11 2 4 0 0 0 320 240
15 16 9
