740 740 740 740 740 740 740 740 740 740 740 0 0 0 0 0 0 0 0 0 0 0 0 0 0 0 0 0 0 740 740 740 740 740 740 740 740 740 740 740 
740 740 740 740 740 740 740 740 740 740 740 0 0 0 0 0 0 0 0 0 0 0 0 0 0 0 0 0 0 740 740 740 740 740 740 740 740 740 740 740 
740 740 740 740 740 740 740 740 740 740 740 0 0 0 0 0 0 0 0 0 0 0 0 0 0 0 0 0 0 740 740 740 740 740 740 740 740 740 740 740 
740 740 740 740 740 740 740 740 740 740 740 0 0 0 0 0 0 0 0 0 0 0 0 0 0 0 0 0 0 740 740 740 740 740 740 740 740 740 740 740 
740 740 740 740 740 740 740 740 740 740 740 0 0 0 0 0 0 0 0 0 0 0 0 0 0 0 0 0 0 740 740 740 740 740 740 740 740 740 740 740 
740 740 740 740 740 740 740 740 740 740 740 0 0 0 0 0 0 0 0 0 0 0 0 0 0 0 0 0 0 740 740 740 740 740 740 740 740 740 740 740 
740 740 740 740 740 740 740 740 740 740 740 0 0 0 0 0 0 0 0 0 0 0 0 0 0 0 0 0 740 740 740 740 740 740 740 740 740 740 740 740 
740 740 740 740 740 740 740 740 740 740 740 740 0 0 0 0 0 0 0 0 0 0 0 0 0 0 0 0 740 740 740 740 740 740 740 740 740 740 740 740 
740 740 740 740 740 740 740 740 740 740 740 740 0 0 0 0 0 0 0 0 0 0 0 0 0 0 0 0 740 740 740 740 740 740 740 740 740 740 740 740 
740 740 740 740 740 740 740 740 740 740 740 740 0 0 0 0 0 0 0 0 0 0 0 0 0 0 0 0 740 740 740 740 740 740 740 740 740 740 740 740 
740 740 740 740 740 740 740 740 740 740 740 740 0 0 0 0 0 0 0 0 0 0 0 0 0 0 0 0 740 740 740 740 740 740 740 740 740 740 740 740 
740 740 740 740 740 740 740 740 740 740 740 740 0 0 0 0 0 0 0 0 0 0 0 0 0 0 0 0 740 740 740 740 740 740 740 740 740 740 740 740 
740 740 740 740 740 740 740 740 740 740 740 740 740 0 0 0 0 0 0 0 0 0 0 0 0 0 0 740 740 740 740 740 740 740 740 740 740 740 740 740 
740 740 740 740 740 740 740 740 740 740 740 740 740 0 0 0 0 0 0 0 0 0 0 0 0 0 0 740 740 740 740 740 740 740 740 740 740 740 740 740 
740 740 740 740 740 740 740 740 740 740 740 740 740 0 0 0 0 0 0 0 0 0 0 0 0 0 0 740 740 740 740 740 740 740 740 740 740 740 740 740 
740 740 740 740 740 740 740 740 740 740 740 740 740 0 0 0 0 0 0 0 0 0 0 0 0 0 0 740 740 740 740 740 740 740 740 740 740 740 740 740 
740 740 740 740 740 740 740 740 740 740 740 740 740 0 0 0 0 0 0 0 0 0 0 0 0 0 0 740 740 740 740 740 740 740 740 740 740 740 740 740 
740 740 740 740 740 740 740 740 740 740 740 740 740 0 0 0 0 0 0 0 0 0 0 0 0 0 0 740 740 740 740 740 740 740 740 740 740 740 740 740 
740 740 740 740 740 740 740 740 740 740 740 740 740 740 0 0 0 0 0 0 0 0 0 0 0 0 740 740 740 740 740 740 740 740 740 740 740 740 740 740 
740 740 740 740 740 740 740 740 740 740 740 740 740 740 0 0 0 0 0 0 0 0 0 0 0 0 740 740 740 740 740 740 740 740 740 740 740 740 740 740 
740 740 740 740 740 740 740 740 740 740 740 740 740 740 0 0 0 0 0 0 0 0 0 0 0 0 740 740 740 740 740 740 740 740 740 740 740 740 740 740 
740 740 740 740 740 740 740 740 740 740 740 740 740 740 740 0 0 0 0 0 0 0 0 0 0 740 740 740 740 740 740 740 740 740 740 740 740 740 740 740 
740 740 740 740 740 740 740 740 740 740 740 740 740 740 740 0 0 0 0 0 0 0 0 0 0 740 740 740 740 740 740 740 740 740 740 740 740 740 740 740 
740 740 740 740 740 740 740 740 740 740 740 740 740 740 740 0 0 0 0 0 0 0 0 0 0 740 740 740 740 740 740 740 740 740 740 740 740 740 740 740 
740 740 740 740 740 740 740 740 740 740 740 740 740 740 740 0 0 0 0 0 0 0 0 0 0 740 740 740 740 740 740 740 740 740 740 740 740 740 740 740 
740 740 740 740 740 740 740 740 740 740 740 740 740 740 740 740 0 0 0 0 0 0 0 0 740 740 740 740 740 740 740 740 740 740 740 740 740 740 740 740 
740 740 740 740 740 740 740 740 740 740 740 740 740 740 740 740 0 0 0 0 0 0 0 0 740 740 740 740 740 740 740 740 740 740 740 740 740 740 740 740 
740 740 740 740 740 740 740 740 740 740 740 740 740 740 740 740 0 0 0 0 0 0 0 0 740 740 740 740 740 740 740 740 740 740 740 740 740 740 740 740 
740 740 740 740 740 740 740 740 740 740 740 740 740 740 740 740 0 0 0 0 0 0 0 0 740 740 740 740 740 740 740 740 740 740 740 740 740 740 740 740 
0
