92 92 92 92 92 92 92 92 92 92 92 92 92 92 92 92 92 92 92 92 92 92 92 92 92 92 92 92 92 92 92 92 92 92 92 92 92 92 92 92 
92 92 92 92 92 92 92 92 92 92 92 92 92 92 92 92 92 92 92 92 92 92 92 92 92 92 92 92 92 92 92 92 92 92 93 253 253 253 253 253 
92 92 92 92 92 92 93 253 253 253 253 253 253 253 253 253 253 253 253 253 253 253 253 253 253 253 253 253 253 253 253 253 253 253 254 9 9 9 9 9 
92 92 92 92 92 92 214 0 0 0 0 0 0 0 0 0 0 0 0 0 0 0 0 0 0 0 0 0 0 0 0 0 0 0 0 0 0 0 0 0 
92 92 92 92 92 92 214 0 0 0 0 0 0 0 0 0 0 0 0 0 0 0 0 0 0 0 0 0 0 0 0 0 0 0 0 0 0 0 0 0 
92 92 92 92 92 92 214 0 0 0 0 0 0 0 0 0 0 0 0 0 0 0 0 0 0 0 0 0 0 0 0 0 0 0 0 0 0 0 0 0 
92 92 92 92 92 92 214 0 0 0 0 0 0 0 0 0 0 0 0 0 0 0 0 0 0 0 0 0 0 0 0 0 0 0 0 0 0 0 0 0 
92 92 92 92 92 92 214 0 0 0 0 0 0 0 0 0 0 0 0 0 0 0 0 0 0 0 0 0 0 0 0 0 0 0 0 0 0 0 0 0 
92 92 92 92 92 92 214 0 0 0 0 0 0 0 0 0 0 0 0 0 0 0 0 0 0 0 0 0 0 0 0 0 0 0 0 0 0 0 0 0 
92 92 92 92 92 92 214 0 0 0 0 0 0 0 0 0 0 0 0 0 0 0 0 0 0 0 0 0 0 0 0 0 0 0 0 0 0 0 0 0 
92 92 92 92 92 92 214 0 0 0 0 172 173 173 173 173 173 173 173 173 173 173 173 173 173 173 173 173 173 173 173 173 173 173 173 173 173 173 173 173 
92 92 92 92 92 92 214 0 0 0 0 212 92 92 92 92 92 92 92 92 92 92 92 92 92 92 92 92 92 92 92 92 92 92 92 92 92 92 92 92 
92 92 92 92 92 92 214 0 0 0 0 212 92 92 92 92 92 92 92 92 92 92 92 92 92 92 92 92 92 92 92 92 92 92 92 92 92 92 92 92 
92 92 92 92 92 92 214 0 0 763 764 212 92 92 92 92 92 92 92 92 92 92 92 92 92 92 93 253 253 253 253 253 253 253 253 253 253 253 253 253 
92 92 92 92 92 92 214 0 0 803 683 212 92 92 92 92 92 92 92 92 92 92 92 92 92 92 214 0 0 0 0 0 0 0 0 0 0 0 0 0 
92 92 92 92 92 92 214 0 0 803 683 212 92 92 92 92 92 92 92 92 92 92 92 92 92 92 214 0 0 0 0 0 0 0 0 0 0 0 0 0 
92 92 92 92 92 92 214 0 0 803 683 212 92 92 92 92 92 92 92 92 92 92 92 92 92 92 214 0 0 0 0 0 0 0 0 0 0 0 0 0 
92 92 92 92 92 92 214 0 0 803 683 212 92 92 92 92 92 92 92 92 92 92 92 92 92 92 214 0 0 0 0 0 0 0 0 0 0 0 0 0 
92 92 92 92 92 92 214 0 0 803 683 212 92 92 92 92 92 92 92 92 92 92 92 92 92 92 214 0 0 0 0 0 0 0 0 0 0 0 0 0 
92 92 92 92 92 92 214 0 0 803 683 212 92 92 92 92 92 92 92 92 92 92 92 92 92 92 214 0 0 0 0 0 0 0 0 0 0 0 0 0 
92 92 92 92 92 92 214 0 0 803 683 212 92 92 93 253 253 253 253 253 253 253 253 253 253 253 254 0 0 0 0 0 0 0 0 0 0 0 0 0 
92 92 92 92 92 92 214 0 0 803 683 212 92 92 214 0 0 0 0 0 0 0 0 0 0 0 0 0 0 0 0 0 0 0 0 0 172 173 173 173 
92 92 92 92 92 92 214 0 0 803 683 212 92 92 214 683 683 683 683 683 683 683 683 805 0 0 0 0 0 0 0 0 0 0 0 0 212 92 92 92 
92 92 92 92 92 92 214 0 0 803 683 212 92 92 214 683 683 683 683 683 683 683 683 805 0 0 0 0 0 0 0 0 0 0 0 0 212 92 92 92 
92 92 92 92 92 92 214 0 0 803 683 212 92 92 214 683 683 683 683 683 683 683 683 805 0 0 0 0 0 0 0 0 0 0 0 0 212 92 92 92 
92 92 92 92 92 92 214 0 0 803 683 212 92 92 214 683 683 683 683 683 683 683 683 805 0 0 0 0 0 0 0 0 0 0 0 0 212 92 92 92 
92 92 92 92 92 92 214 0 0 803 683 212 92 92 214 683 683 683 683 683 683 683 683 805 0 0 0 0 0 0 0 0 0 0 0 0 212 92 92 92 
92 92 92 92 92 92 214 0 0 803 683 212 92 92 214 683 683 683 683 683 0 0 0 0 0 0 0 0 0 0 0 0 0 0 0 0 212 92 92 92 
92 92 92 92 92 92 214 0 0 803 683 212 92 92 214 683 683 683 683 683 172 173 173 173 173 173 173 173 173 173 173 174 0 0 0 0 212 92 92 92 
17
7 3 2 7 4 0 0 320 240
15 3 2 7 4 0 0 320 240
23 3 2 7 4 0 0 320 240
11 9 2 7 4 0 0 320 240
27 9 2 7 4 0 0 320 240
35 9 2 7 4 0 0 320 240
8 4 10 0
36 20 2 5 4 0 0 320 240
35 14 2 7 4 0 0 320 240
20 27 2 7 4 0 0 320 240
28 27 2 5 4 0 0 320 240
31 3 2 5 4 0 0 320 240
15 21 2 7 4 0 0 320 240
23 21 2 5 4 0 0 320 240
27 14 2 7 4 0 0 320 240
19 9 2 7 4 0 0 320 240
28 15 10 0
