492 614 680 680 680 680 652 653 653 653 653 653 653 653 653 653 653 653 653 653 653 653 653 653 653 653 653 654 680 680 802 0 0 0 612 492 492 492 492 492 
492 614 680 680 680 680 680 802 0 0 0 0 0 0 0 800 680 680 680 680 680 680 680 680 680 680 680 680 680 680 802 0 0 0 612 492 492 492 492 492 
492 614 680 680 680 680 680 802 0 0 0 0 0 0 0 800 680 680 680 680 680 680 680 680 680 680 680 680 680 680 802 0 0 0 612 492 492 492 492 492 
492 614 680 680 680 680 680 802 0 0 0 0 0 0 0 800 680 680 680 680 680 680 680 680 680 680 680 680 680 680 802 0 0 0 612 492 492 492 492 492 
492 614 680 680 680 680 680 802 0 0 0 0 0 0 0 800 680 680 680 680 680 680 680 680 680 680 680 680 680 680 802 0 0 0 612 492 492 492 492 492 
492 614 680 680 680 680 680 802 0 0 0 0 0 0 0 800 680 680 680 6 6 6 6 6 6 6 6 6 6 6 1122 8 8 8 612 492 492 492 492 492 
492 614 680 680 680 680 680 802 0 0 0 0 0 0 0 840 841 841 841 572 573 573 573 573 573 573 573 573 573 573 573 573 573 573 534 492 492 492 492 492 
492 614 680 680 680 680 680 802 0 0 0 0 0 0 0 0 0 0 0 612 492 492 493 653 653 653 653 653 653 653 653 653 653 653 653 653 653 494 492 492 
492 614 680 680 680 680 680 802 0 0 0 0 0 0 0 0 0 0 0 652 653 653 654 9 9 9 9 9 9 9 9 9 9 9 9 9 9 612 492 492 
492 533 573 573 573 573 573 573 573 573 574 0 0 0 0 0 0 0 0 0 0 0 0 0 0 0 0 0 0 0 0 0 0 0 0 0 0 612 492 492 
492 492 492 492 492 492 492 492 492 492 533 573 573 573 574 0 0 0 0 572 573 573 574 0 0 0 0 0 0 0 0 0 0 0 0 0 0 612 492 492 
492 492 492 492 492 492 492 492 492 492 492 492 492 492 614 0 0 0 0 612 492 492 614 0 0 0 0 0 0 0 0 0 0 0 0 0 0 612 492 492 
492 492 492 492 492 492 492 492 492 492 492 492 492 492 614 0 0 0 0 612 492 492 614 0 0 0 0 0 0 0 0 0 0 0 0 0 0 612 492 492 
492 492 492 492 492 492 492 492 492 492 492 492 492 492 614 0 0 0 0 612 492 492 614 0 0 0 0 0 0 0 0 0 0 0 0 0 0 612 492 492 
492 492 492 492 492 492 492 492 492 492 492 492 492 492 614 0 0 0 0 612 492 492 614 0 0 0 0 8 8 8 8 8 8 0 0 0 0 612 492 492 
492 492 492 492 492 492 492 492 492 492 492 492 492 492 614 0 0 0 0 612 492 492 614 0 0 0 0 572 573 573 573 573 574 0 0 0 0 652 653 653 
492 492 492 492 492 492 492 492 492 492 492 492 492 492 614 0 0 0 0 612 492 492 614 0 0 0 0 612 493 653 653 653 654 0 0 0 0 9 9 9 
492 492 492 492 492 492 492 492 492 492 492 492 492 492 614 0 0 0 0 612 492 492 614 0 0 0 0 612 614 0 0 0 0 0 0 0 0 0 0 0 
492 492 492 492 492 492 492 492 492 492 492 492 492 492 614 8 8 8 8 612 492 492 614 0 0 0 0 612 614 0 0 0 0 0 0 0 0 0 0 0 
492 492 492 492 492 492 492 492 492 492 492 492 492 492 533 573 573 573 573 534 492 492 533 573 573 573 573 534 614 0 0 0 0 0 0 0 0 0 0 0 
653 653 653 653 653 653 653 653 653 653 653 653 653 653 653 653 653 653 653 653 653 653 653 653 653 653 653 653 654 0 0 0 0 0 0 0 0 0 0 0 
680 680 680 680 680 680 680 802 0 0 0 0 0 0 0 0 0 0 0 0 0 0 0 0 0 0 0 0 0 0 0 0 0 0 0 0 0 0 0 0 
680 680 680 680 680 680 680 802 0 0 0 0 0 0 0 0 0 0 0 0 0 0 0 0 0 0 0 0 0 0 0 0 0 0 0 0 0 0 0 0 
841 841 841 841 841 841 841 842 0 0 0 0 0 0 0 0 0 0 0 0 0 0 0 0 0 0 0 0 0 0 0 0 0 0 0 0 0 0 0 0 
0 0 0 0 0 0 0 0 0 0 0 0 0 0 0 0 0 0 0 0 0 0 0 0 0 0 0 0 0 0 0 0 0 0 0 0 0 0 0 0 
0 0 0 0 0 0 0 0 0 0 0 0 0 0 0 0 0 0 0 0 0 0 0 0 0 0 0 0 0 0 0 0 0 0 0 0 0 0 0 0 
573 573 573 573 573 573 573 573 573 573 573 573 573 573 573 573 573 573 573 573 573 573 573 573 573 573 573 573 573 573 573 573 573 573 573 573 573 573 573 573 
492 492 492 492 492 492 492 492 492 492 492 492 492 492 492 492 492 492 492 492 492 492 492 492 492 492 492 492 492 492 492 492 492 492 492 492 492 492 492 492 
492 492 492 492 492 492 492 492 492 492 492 492 492 492 492 492 492 492 492 492 492 492 492 492 492 492 492 492 492 492 492 492 492 492 492 492 492 492 492 492 
6
15 9 2 4 0 0 0 320 240
15 14 2 4 0 0 0 320 240
15 16 2 4 0 0 0 320 240
11 9 2 3 0 0 0 320 240
24 16 9
30 17 10 0
