101 101 101 101 101 101 101 101 101 101 101 101 101 101 101 101 101 101 101 101 223 0 0 0 0 221 101 101 101 101 101 101 101 101 101 101 101 101 101 101 
101 101 101 101 101 101 101 101 101 101 101 101 101 101 101 101 101 101 101 101 223 0 0 0 0 221 101 101 101 101 101 101 101 101 101 101 101 101 101 101 
101 101 101 101 101 101 101 101 101 101 101 101 101 101 101 101 101 101 101 101 223 0 0 0 0 221 101 101 101 101 101 101 101 101 101 101 101 101 101 101 
101 101 101 101 101 101 101 101 101 101 101 101 101 101 101 101 101 101 101 101 223 0 0 0 0 221 101 101 101 101 101 101 101 101 101 101 101 101 101 101 
101 101 101 101 101 101 101 101 101 101 101 101 101 101 101 101 101 101 101 101 223 0 0 0 0 261 262 262 262 262 262 262 262 262 262 262 262 262 262 262 
101 101 101 101 101 101 101 101 101 101 101 101 101 101 101 101 101 101 101 101 223 0 0 0 0 0 0 0 0 0 0 0 0 0 0 0 0 0 0 0 
101 101 101 101 101 101 101 101 101 101 101 101 101 101 101 101 101 101 101 101 223 0 0 0 0 0 0 0 0 0 0 0 0 0 0 0 0 0 0 0 
101 101 101 101 101 101 101 101 101 101 101 101 101 101 101 101 101 101 101 101 223 0 0 0 0 0 0 0 0 0 0 0 0 0 0 0 0 0 0 0 
101 101 101 101 101 101 101 101 101 101 101 101 101 101 101 101 101 101 101 101 223 0 0 0 0 0 0 0 0 0 0 0 0 0 0 0 0 0 0 0 
101 101 101 101 101 101 101 101 101 101 101 101 101 101 101 101 101 101 101 101 142 182 182 182 182 182 182 182 182 182 182 182 182 182 182 182 182 182 182 182 
101 101 101 101 101 101 101 101 101 101 101 101 101 101 101 101 101 101 101 101 101 101 101 101 101 101 101 101 101 101 101 101 101 101 101 101 101 101 101 101 
101 101 101 101 101 101 101 101 101 101 101 101 101 101 101 101 101 101 101 101 101 101 101 101 101 101 101 101 101 101 101 101 101 101 101 101 101 101 101 101 
101 101 101 101 101 101 101 101 101 101 101 101 101 101 101 101 101 101 101 101 101 101 101 101 101 101 101 101 101 101 101 101 101 101 101 101 101 101 101 101 
101 101 101 101 101 101 101 101 101 101 101 101 101 101 101 101 101 101 101 101 101 101 101 101 101 101 101 101 101 101 101 101 101 101 101 101 101 101 101 101 
101 101 101 101 101 101 101 101 101 101 101 101 101 101 101 101 101 101 101 101 101 101 101 101 101 101 101 101 101 101 101 101 101 101 101 101 101 101 101 101 
101 101 101 101 101 101 101 101 101 102 262 262 262 262 262 262 262 262 262 262 262 262 262 262 262 262 262 262 262 262 262 262 262 262 103 101 101 101 101 101 
101 102 262 262 262 262 262 262 262 263 0 0 0 0 0 0 0 0 0 0 0 0 0 0 0 0 0 0 0 0 0 0 0 0 221 102 262 262 262 262 
101 223 0 0 0 0 0 0 0 0 0 0 0 0 0 0 0 0 0 0 0 0 0 0 0 0 0 0 0 0 0 0 0 0 261 263 0 0 0 0 
101 223 0 0 0 0 0 0 0 0 0 0 0 0 0 0 0 0 0 0 0 0 0 0 0 0 0 0 0 0 0 0 0 0 0 0 0 0 0 0 
101 223 0 0 0 0 0 0 0 0 0 0 0 0 0 0 0 0 0 0 0 0 0 0 0 0 0 0 0 0 0 0 0 0 0 0 0 0 0 0 
101 223 0 0 0 0 0 0 0 0 0 0 0 0 0 0 0 0 0 0 0 0 0 0 0 0 0 0 0 0 0 0 0 0 181 183 0 0 0 0 
101 142 182 182 182 182 182 182 182 182 182 183 0 0 0 0 181 182 182 182 182 182 182 182 182 182 182 182 182 183 0 0 0 0 221 142 182 182 182 182 
101 101 101 101 101 101 101 102 262 262 262 263 0 0 0 0 221 101 101 101 101 101 101 101 101 101 101 101 101 223 0 0 0 0 261 262 262 262 262 262 
101 101 101 101 101 101 101 223 0 0 0 0 0 0 0 0 221 101 101 101 101 101 101 101 101 101 101 101 101 223 0 0 0 0 0 0 0 0 0 0 
101 101 101 101 101 101 101 223 0 0 0 0 0 0 0 0 221 101 101 101 101 101 101 101 101 101 101 101 101 223 0 0 0 0 0 0 0 0 0 0 
101 101 101 101 101 101 101 223 0 0 0 0 0 0 0 0 221 101 101 101 101 101 101 101 101 101 101 101 101 223 0 0 0 0 0 0 0 0 0 0 
101 101 101 101 101 101 101 223 0 0 0 0 0 0 0 0 221 101 101 101 101 101 101 101 101 101 101 101 101 223 0 0 0 0 0 0 0 0 0 0 
101 101 101 101 101 101 101 223 0 0 0 0 181 182 182 182 143 101 101 101 101 101 101 101 101 101 101 101 101 142 182 182 182 182 182 182 182 182 182 182 
101 101 101 101 101 101 101 223 0 0 0 0 221 101 101 101 101 101 101 101 101 101 101 101 101 101 101 101 101 101 101 101 101 101 101 101 101 101 101 101 
5
3 18 1 3 0 0 0 320 240
9 23 10 0
10 16 2 7 4 0 0 320 240
18 16 2 7 4 0 0 320 240
26 16 2 7 4 0 0 320 240
