107 107 107 107 107 107 107 107 229 0 0 0 0 809 689 689 227 107 107 107 107 107 107 229 689 689 811 0 0 0 0 227 107 107 107 107 107 107 107 107 
268 268 268 268 268 268 268 268 269 0 0 0 0 809 689 689 227 107 107 107 107 107 107 229 689 689 811 0 0 0 0 267 268 268 268 268 268 268 268 268 
9 9 9 9 9 9 9 9 9 0 0 0 0 809 689 689 227 107 107 107 107 107 107 229 689 689 811 0 0 0 0 9 9 9 9 9 9 9 9 9 
0 0 0 0 0 0 0 0 0 0 0 0 0 809 689 689 227 107 107 107 107 107 107 229 689 689 811 0 0 0 0 0 0 0 0 0 0 0 0 0 
0 0 0 0 0 0 0 0 0 0 0 0 0 809 689 689 227 107 107 107 107 107 107 229 689 689 811 0 0 0 0 0 0 0 0 0 0 0 0 0 
0 0 0 0 0 0 0 0 0 0 0 0 0 809 689 689 227 107 107 107 107 107 107 229 689 689 811 0 0 0 0 0 0 0 0 0 0 0 0 0 
0 0 0 0 0 0 0 0 0 0 0 0 0 809 689 689 227 107 107 107 107 107 107 229 689 689 811 0 0 0 0 0 0 0 0 0 0 0 0 0 
0 0 0 0 0 0 0 0 0 0 0 0 0 809 689 689 227 107 107 107 107 107 107 229 689 689 811 0 0 0 0 0 0 0 0 0 0 0 0 0 
0 0 0 0 0 0 0 0 0 0 0 0 0 809 689 689 227 107 107 107 107 107 107 229 689 689 811 0 0 0 0 0 0 0 0 0 0 0 0 0 
0 0 0 0 0 0 0 0 0 0 0 0 0 809 689 689 227 107 107 107 107 107 107 229 689 689 811 0 0 0 0 0 0 0 0 0 0 0 0 0 
0 0 0 0 0 0 0 0 0 0 0 0 0 809 689 689 227 107 107 107 107 107 107 229 689 689 811 0 0 0 0 0 0 0 0 0 0 0 0 0 
0 0 0 0 0 0 0 0 0 0 0 0 0 809 689 689 227 107 107 107 107 107 107 229 689 689 811 0 0 0 0 0 0 0 0 0 0 0 0 0 
0 0 0 0 0 0 0 0 0 0 0 0 0 809 689 689 227 107 107 107 107 107 107 229 689 689 811 0 0 0 0 0 0 0 0 0 0 0 0 0 
0 0 0 0 0 0 0 0 0 0 0 0 0 0 0 0 267 268 268 268 268 268 268 269 0 0 0 0 0 0 0 0 0 0 0 0 0 0 0 0 
0 0 0 0 0 0 0 0 0 0 0 0 0 0 0 0 0 0 0 0 0 0 0 0 0 0 0 0 0 0 0 0 0 0 0 0 0 0 0 0 
0 0 0 0 0 0 0 0 0 0 0 0 0 809 689 689 689 689 689 689 689 689 689 689 689 689 811 0 0 0 0 0 0 0 0 0 0 0 0 0 
0 0 0 0 0 0 0 0 0 0 0 0 0 809 689 689 689 689 689 689 689 689 689 689 689 689 811 0 0 0 0 0 0 0 0 0 0 0 0 0 
0 0 0 0 0 0 0 0 0 0 0 0 0 809 689 689 689 689 689 689 689 689 689 689 689 689 811 0 0 0 0 0 0 0 0 0 0 0 0 0 
0 0 0 0 0 0 0 0 0 0 0 0 0 809 689 689 689 689 689 689 689 689 689 689 689 689 811 0 0 0 0 0 0 0 0 0 0 0 0 0 
0 0 0 0 0 0 0 0 0 0 0 0 0 809 689 689 689 689 689 689 689 689 689 689 689 689 811 0 0 0 0 0 0 0 0 0 0 0 0 0 
0 0 0 0 0 0 0 0 0 0 0 0 0 809 689 689 689 689 689 689 689 689 689 689 689 689 811 0 0 0 0 0 0 0 0 0 0 0 0 0 
0 0 0 0 0 0 0 0 0 0 0 0 0 849 850 850 850 850 850 850 850 850 850 850 850 850 851 0 0 0 0 0 0 0 0 0 0 0 0 0 
0 0 0 0 0 0 0 0 0 0 0 0 0 0 0 0 0 0 0 0 0 0 0 0 0 0 0 0 0 0 0 0 0 0 0 0 0 0 0 0 
0 0 0 0 0 0 0 0 0 0 0 0 0 0 0 0 0 0 0 0 0 0 0 0 0 0 0 0 0 0 0 0 0 0 0 0 0 0 0 0 
0 0 0 0 0 0 0 0 0 0 0 0 0 0 0 0 0 0 0 0 0 0 0 0 0 0 0 0 0 0 0 0 0 0 0 0 0 0 0 0 
8 8 8 8 8 8 8 8 8 8 8 8 8 8 8 8 8 8 8 8 8 8 8 8 8 8 8 8 8 8 8 8 8 8 8 8 8 8 8 8 
188 188 188 188 188 188 188 188 188 188 188 188 188 188 188 188 188 188 188 188 188 188 188 188 188 188 188 188 188 188 188 188 188 188 188 188 188 188 188 188 
107 107 107 107 107 107 107 107 107 107 107 107 107 107 107 107 107 107 107 107 107 107 107 107 107 107 107 107 107 107 107 107 107 107 107 107 107 107 107 107 
107 107 107 107 107 107 107 107 107 107 107 107 107 107 107 107 107 107 107 107 107 107 107 107 107 107 107 107 107 107 107 107 107 107 107 107 107 107 107 107 
10
0 13 2 8 4 0 0 320 240
8 13 2 8 4 0 0 320 240
24 13 2 8 4 0 0 320 240
32 13 2 8 4 0 0 320 240
19 15 10 0
0 14 2 7 4 0 0 320 240
8 14 2 7 4 0 0 320 240
16 14 2 7 4 0 0 320 240
24 14 2 7 4 0 0 320 240
32 14 2 7 4 0 0 320 240
