0 0 0 0 0 433 313 435 0 0 809 689 433 313 313 314 474 474 315 313 313 313 313 313 313 313 313 313 313 435 689 689 811 0 0 433 313 313 313 313 
0 0 0 0 0 433 313 435 0 0 809 689 433 313 313 435 689 689 433 313 313 313 313 313 313 313 313 313 313 435 689 689 811 0 0 433 313 313 313 313 
0 0 0 0 0 433 313 435 0 0 809 689 473 474 474 475 689 689 473 474 474 474 474 474 474 474 474 315 313 435 689 689 811 0 0 433 313 313 313 313 
0 0 0 0 0 433 313 435 0 0 809 689 0 0 0 0 689 689 0 0 0 0 0 0 0 0 0 433 313 435 689 689 811 0 0 433 313 313 313 313 
0 0 0 0 0 433 313 435 0 0 809 689 689 689 689 689 689 689 689 689 689 689 689 689 689 689 689 433 313 435 689 689 811 0 0 433 313 313 313 313 
0 0 0 0 0 433 313 435 0 0 809 689 689 689 689 689 689 689 689 689 689 689 689 689 689 689 689 433 313 435 689 689 811 0 0 433 313 313 313 313 
394 394 394 394 394 355 313 435 0 0 809 689 689 689 689 689 689 689 689 689 689 689 689 689 689 689 689 433 313 435 689 689 811 0 0 433 313 313 313 313 
474 474 474 474 474 315 313 435 0 0 809 689 689 689 689 689 689 689 689 689 689 689 689 689 689 689 689 433 313 435 689 689 811 0 0 433 313 313 313 313 
0 0 0 0 0 433 313 435 0 0 0 0 0 0 0 0 689 689 0 0 0 0 0 689 689 689 689 433 313 435 689 689 811 0 0 433 313 313 313 313 
0 0 0 0 0 433 313 354 394 394 394 394 394 394 394 395 689 689 393 394 394 394 395 689 689 689 689 433 313 435 689 689 811 0 0 433 313 313 313 313 
0 0 0 0 0 433 313 314 474 474 474 474 474 474 474 475 689 689 473 474 474 474 475 689 689 689 689 433 313 435 689 689 811 0 0 433 313 313 313 313 
0 0 0 0 0 433 313 435 0 0 0 0 0 0 0 0 689 689 0 0 0 0 0 689 689 689 689 433 313 435 689 689 811 0 0 433 313 313 313 313 
0 0 0 0 0 433 313 435 0 0 809 689 689 689 689 689 689 689 689 689 689 689 689 689 689 689 689 433 313 435 689 689 811 0 0 433 313 313 313 313 
0 0 0 0 0 433 313 435 0 0 809 689 689 689 689 689 689 689 689 689 689 689 689 689 689 689 689 433 313 435 689 689 811 0 0 433 313 313 313 313 
0 0 0 0 0 433 313 435 0 0 809 689 689 689 689 689 689 689 689 689 689 689 689 689 689 689 689 433 313 435 689 689 811 0 0 433 313 313 313 313 
0 0 0 0 0 433 313 435 0 0 809 689 689 689 689 689 689 689 689 689 689 689 689 689 689 689 689 433 313 435 689 689 811 0 0 433 313 313 313 313 
0 0 0 0 0 433 313 435 0 0 809 689 689 689 689 689 689 689 689 689 689 689 689 689 689 689 689 433 313 435 689 689 811 0 0 433 313 313 313 313 
0 0 0 0 0 433 313 435 0 0 809 689 0 0 0 0 0 0 689 689 0 0 0 0 0 0 0 433 313 435 689 689 811 0 0 433 313 313 313 313 
0 0 0 0 0 433 313 435 0 0 809 689 393 394 394 394 394 395 689 689 393 394 394 394 394 394 394 355 313 435 689 689 811 0 0 433 313 313 313 313 
0 0 0 0 0 433 313 435 0 0 809 689 473 474 474 474 474 475 689 689 473 474 474 474 474 474 474 474 474 475 689 689 811 0 0 433 313 313 313 313 
0 0 0 0 0 433 313 435 0 0 809 689 0 0 0 0 0 0 689 689 0 0 0 0 0 0 0 0 0 0 689 689 811 0 0 433 313 313 313 313 
0 0 0 0 0 433 313 435 0 0 809 689 689 689 689 689 689 689 689 689 689 689 689 689 689 689 689 689 689 689 689 689 811 0 0 433 313 313 313 313 
0 0 0 0 0 433 313 435 0 0 849 850 850 850 850 850 850 850 850 850 850 850 850 850 850 850 850 850 850 850 850 850 851 0 0 433 313 313 313 313 
0 0 0 0 0 433 313 435 0 0 0 0 0 0 0 0 0 0 0 0 0 0 0 0 0 0 0 0 0 0 0 0 0 0 0 433 313 313 313 313 
0 0 0 0 0 433 313 435 0 0 0 0 0 0 0 0 0 0 0 0 0 0 0 0 0 0 0 0 0 0 0 0 0 0 0 433 313 313 313 313 
0 0 0 0 0 433 313 435 0 0 0 0 0 0 0 0 0 0 0 0 0 0 0 0 0 0 0 0 0 0 0 0 0 0 0 433 313 313 313 313 
394 394 394 394 394 355 313 354 394 394 394 394 394 394 394 394 394 395 0 0 393 394 394 394 394 394 394 394 394 394 394 394 394 394 394 355 313 313 313 313 
313 313 313 313 313 313 313 313 313 313 313 313 313 313 313 313 313 435 0 0 433 313 313 313 313 313 313 313 313 313 313 313 313 313 313 313 313 313 313 313 
313 313 313 313 313 313 313 313 313 313 313 313 313 313 313 313 313 354 394 394 355 313 313 313 313 313 313 313 313 313 313 313 313 313 313 313 313 313 313 313 
24
18 26 1 1 6 0 0 320 240
8 25 2 8 4 0 0 320 240
14 25 2 6 4 0 0 320 240
20 25 2 8 4 0 0 320 240
27 25 2 8 4 0 0 320 240
12 20 2 6 4 0 0 320 240
14 20 2 6 4 0 0 320 240
20 20 2 8 4 0 0 320 240
26 20 2 6 4 0 0 320 240
31 23 10 1
16 1 1 0 6 0 0 320 240
12 3 2 6 4 0 0 320 240
18 3 2 8 4 0 0 320 240
23 3 2 6 4 0 0 320 240
8 8 2 8 4 0 0 320 240
18 8 2 6 4 0 0 320 240
19 8 2 6 4 0 0 320 240
18 11 2 6 4 0 0 320 240
19 11 2 6 4 0 0 320 240
8 11 2 8 4 0 0 320 240
12 17 2 6 4 0 0 320 240
14 17 2 6 4 0 0 320 240
20 17 2 6 4 0 0 320 240
23 17 2 6 4 0 0 320 240
