480 480 480 480 480 480 480 480 480 480 480 480 480 480 480 480 480 480 480 480 480 480 480 480 480 480 480 480 480 480 480 480 480 480 480 480 480 480 480 480 
480 480 480 480 480 480 480 480 480 480 480 480 480 480 480 480 480 480 480 480 480 480 480 480 480 480 480 480 480 480 480 480 480 480 480 480 480 480 480 480 
480 480 480 480 480 480 481 641 641 641 641 641 641 641 641 641 641 482 480 480 481 641 641 641 641 641 641 641 641 641 641 482 480 480 480 480 480 480 480 480 
480 480 480 480 480 480 602 7 7 7 7 7 7 7 7 7 7 600 480 480 602 7 7 7 7 7 7 7 7 7 7 600 480 480 480 480 480 480 480 480 
480 480 480 480 480 480 602 0 0 0 0 0 0 0 0 0 0 600 480 480 602 0 0 0 0 0 0 0 0 0 0 600 480 480 480 480 480 480 480 480 
480 480 480 480 480 480 602 0 0 0 0 0 0 0 0 0 0 600 480 480 602 0 0 0 0 0 0 0 0 0 0 600 480 480 480 480 480 480 480 480 
641 641 641 641 641 641 642 0 0 0 0 0 0 0 0 0 0 640 641 641 642 0 0 0 0 0 0 0 0 0 0 640 641 641 641 641 641 641 641 641 
0 0 0 0 0 0 0 0 0 0 0 0 0 0 0 0 0 0 0 0 0 0 0 0 0 0 0 0 0 0 0 0 680 0 0 0 0 0 0 0 
0 0 0 0 0 0 0 0 0 0 0 0 0 0 0 0 0 0 0 0 0 0 0 0 0 0 0 0 0 0 0 0 680 0 0 0 0 0 0 0 
0 0 0 0 0 0 0 0 0 0 0 0 0 0 0 0 0 0 0 0 0 0 0 0 0 0 0 0 0 0 0 0 680 0 0 0 0 0 0 0 
0 0 0 0 0 0 0 0 0 0 0 0 0 0 0 0 0 0 0 0 0 0 0 0 0 0 0 0 0 0 0 0 680 0 0 0 0 0 0 0 
0 0 0 0 0 0 0 0 0 0 0 0 0 0 0 0 0 0 0 0 0 0 0 0 0 0 0 0 0 0 0 0 680 0 0 0 0 0 0 0 
0 0 0 0 0 0 0 0 0 0 0 0 0 0 0 0 0 0 0 0 0 0 0 0 0 0 0 0 0 0 0 0 680 0 0 0 0 0 0 0 
0 0 0 0 0 0 0 0 0 0 0 0 0 0 0 0 0 0 0 0 0 0 0 0 0 0 0 0 0 0 0 0 680 0 0 560 561 561 561 561 
0 0 0 0 0 0 0 0 0 0 0 0 0 0 0 0 0 0 0 0 0 0 0 0 0 0 0 0 0 0 0 0 680 0 0 600 480 480 480 480 
0 0 0 0 0 0 0 0 0 0 0 0 0 0 0 0 0 0 0 0 0 0 0 0 0 0 0 0 0 0 0 0 680 0 0 600 480 480 480 480 
0 0 0 0 0 0 0 0 0 0 0 0 0 0 0 0 0 0 0 0 0 0 0 0 0 0 0 0 0 0 0 0 680 0 0 600 480 480 480 480 
0 0 0 0 0 0 0 0 0 0 0 0 0 0 0 0 0 0 0 0 0 0 0 0 0 0 0 0 0 0 0 0 680 0 0 600 480 480 480 480 
0 0 0 0 0 0 0 0 0 0 0 0 0 0 0 0 0 0 0 0 0 0 0 0 0 560 562 0 0 0 0 0 680 0 0 600 480 480 480 480 
0 0 0 0 0 0 0 0 0 0 0 0 0 0 0 0 0 0 0 0 0 0 0 0 0 600 602 681 681 681 681 681 682 681 681 600 480 480 480 480 
0 0 0 0 0 0 0 0 0 0 0 0 0 0 0 0 0 0 0 0 0 0 0 0 0 640 642 0 0 0 0 0 680 0 0 600 480 480 480 480 
0 0 0 0 0 0 0 0 0 0 0 0 0 0 0 0 0 0 0 0 0 0 0 0 0 0 0 0 0 0 0 0 680 0 0 600 480 480 480 480 
0 0 0 0 0 0 0 0 0 0 0 0 0 0 0 0 0 0 0 0 0 0 0 0 0 0 0 0 0 0 0 0 680 0 0 600 480 480 480 480 
0 0 0 0 0 0 0 0 0 0 0 0 0 0 0 0 0 0 0 0 0 0 0 0 0 0 0 0 0 0 0 0 680 0 0 600 480 480 480 480 
0 0 0 0 0 0 0 0 0 0 0 560 562 0 0 0 0 0 0 0 0 0 0 0 0 0 0 0 0 0 0 0 680 0 0 600 480 480 480 480 
0 0 0 0 0 0 0 0 0 0 0 600 602 681 681 681 681 681 681 681 681 681 681 681 681 681 681 681 681 681 681 681 682 681 681 600 480 480 480 480 
0 0 0 0 0 0 0 0 0 0 0 640 642 0 0 0 0 0 0 0 0 0 0 0 0 0 0 0 0 0 0 0 680 0 0 600 480 480 480 480 
0 0 0 0 0 0 0 0 0 0 0 0 0 0 0 0 0 0 0 0 0 0 0 0 0 0 0 0 0 0 0 0 680 0 0 600 480 480 480 480 
0 0 0 0 0 0 0 0 0 0 0 0 0 0 0 0 0 0 0 0 0 0 0 0 0 0 0 0 0 0 0 0 680 0 0 600 480 480 480 480 
1
4 7 10 0
