286 286 286 286 286 408 0 0 0 0 0 0 0 0 0 0 0 0 0 0 0 0 0 0 0 0 0 0 0 0 0 0 0 0 0 0 0 0 0 0 
286 286 286 286 287 448 0 0 0 0 0 0 0 0 0 0 0 0 0 0 0 0 0 0 0 0 0 0 0 0 310 352 368 0 0 0 0 0 0 0 
286 286 286 286 408 55 0 0 0 0 0 0 0 0 0 0 0 0 0 0 0 0 0 0 0 0 0 0 0 0 56 406 408 0 0 0 0 0 0 0 
286 286 286 286 408 55 0 0 0 0 0 0 0 0 0 0 0 0 0 0 0 0 0 0 0 0 0 0 0 0 56 406 408 0 0 0 0 0 0 0 
286 286 286 286 408 55 0 0 0 0 0 0 0 0 0 0 0 0 0 0 0 0 0 0 0 0 0 0 0 0 56 406 408 0 0 0 0 0 0 0 
286 286 286 286 408 55 0 0 0 0 0 0 0 0 0 0 0 0 0 0 0 0 0 0 0 0 0 0 0 0 56 406 408 0 0 0 0 0 0 0 
286 286 286 286 408 55 0 0 0 0 0 0 0 0 0 0 0 0 0 0 0 0 0 0 0 0 0 0 0 0 56 406 408 0 0 0 0 0 0 0 
286 286 286 286 408 55 0 0 0 0 0 0 0 0 0 0 0 0 0 0 0 0 0 0 0 0 0 0 0 0 56 406 408 0 0 0 0 0 0 0 
286 286 286 286 408 55 0 0 0 0 0 0 0 0 0 0 0 0 0 0 0 0 67 0 0 0 0 0 0 0 56 406 408 0 0 0 0 0 0 0 
286 286 286 286 408 55 0 0 0 0 0 0 0 67 0 0 0 0 0 0 0 56 390 55 0 0 0 0 0 0 56 406 408 0 0 0 0 0 0 0 
286 286 286 286 408 55 0 0 0 0 0 0 56 390 55 0 0 0 0 0 0 56 430 55 0 0 0 0 0 0 56 406 408 0 0 0 0 0 0 0 
286 286 286 286 408 55 0 0 0 0 0 0 56 430 55 0 0 0 0 0 0 56 430 55 0 0 0 0 0 0 310 392 448 0 0 0 0 0 0 0 
286 286 286 286 408 55 0 0 0 0 0 0 56 430 55 0 0 0 0 0 0 56 430 55 0 0 0 0 0 0 0 0 0 0 0 0 0 0 0 0 
286 286 286 286 408 55 0 0 0 0 0 0 56 430 55 0 0 0 0 0 0 56 430 55 0 0 0 0 0 0 0 0 0 0 0 0 0 0 0 0 
286 286 286 286 408 55 0 0 0 0 0 0 56 430 55 0 0 0 0 0 0 56 470 55 0 0 0 0 0 0 0 0 0 0 0 0 0 0 0 0 
286 286 286 286 408 55 0 0 0 0 0 0 56 430 55 0 0 0 0 0 0 0 68 0 0 0 0 0 0 0 0 0 0 0 0 0 0 0 0 0 
286 286 286 286 408 55 0 0 0 0 0 0 56 430 55 0 0 0 0 0 0 0 0 0 0 0 0 0 0 0 0 0 0 0 0 0 0 0 0 0 
286 286 286 286 408 55 0 0 0 0 0 0 56 430 55 0 0 0 0 0 0 0 0 0 0 0 0 0 0 0 0 0 0 0 0 0 0 0 0 0 
286 286 286 286 408 55 0 0 0 0 0 0 56 430 55 0 0 0 0 0 0 0 0 0 0 0 0 0 0 0 0 0 0 0 0 0 0 0 0 0 
286 286 286 286 408 55 0 0 0 0 0 0 56 430 55 0 0 0 0 0 0 0 0 0 0 0 0 0 0 0 0 0 0 0 0 0 0 0 0 0 
286 286 286 286 408 55 0 0 0 0 0 0 56 430 55 0 0 0 0 0 0 0 0 0 0 0 0 0 0 0 0 0 0 0 0 0 0 0 0 0 
286 286 286 286 408 55 0 0 0 0 0 0 56 430 55 0 0 0 0 0 0 0 67 0 0 0 0 0 0 0 0 0 0 0 0 0 0 0 0 0 
286 286 286 286 408 55 0 0 0 0 0 0 56 430 55 0 0 0 0 0 0 56 390 55 0 0 0 0 0 0 0 0 0 0 0 0 0 0 0 0 
286 286 286 286 408 55 0 0 0 0 0 0 56 430 55 0 0 0 0 0 0 56 430 55 0 0 0 0 0 0 0 0 0 0 0 0 0 0 0 0 
286 286 286 286 408 55 0 0 0 0 0 0 56 430 55 0 0 0 0 0 0 56 430 55 0 0 0 0 0 0 0 0 0 0 0 0 0 0 0 0 
286 286 286 286 408 55 0 0 0 0 0 0 56 430 55 0 0 0 0 0 0 56 430 55 0 0 0 0 0 0 0 0 0 0 0 0 0 0 0 0 
286 286 286 286 408 55 0 0 0 0 0 0 56 430 55 0 0 0 0 0 0 56 430 55 0 0 0 0 0 0 0 0 0 0 0 0 0 0 0 0 
286 286 286 286 408 55 0 0 0 0 0 0 56 430 55 0 0 0 0 0 0 56 430 55 0 0 0 0 0 0 0 0 0 0 0 0 0 0 0 0 
286 286 286 286 408 55 0 0 0 0 0 0 56 430 55 0 0 0 0 0 0 56 430 55 0 0 0 0 0 0 0 0 0 0 0 0 0 0 0 0 
4
33 10 11 64
30 12 10 0
6 3 11 192
15 18 11 208
